index,pop_F,pop_M,pop_MF,hholds,fullname
0,37170,31969,69139,39924,ทข.คลองสาน
1,108231,96669,204900,86477,ทข.คลองสามวา
2,49037,44156,93193,77502,ทข.คลองเตย
3,51390,44940,96330,45864,ทข.คันนายาว
4,83503,71794,155297,126570,ทข.จตุจักร
5,78025,70265,148290,73778,ทข.จอมทอง
6,84968,85823,170791,77410,ทข.ดอนเมือง
7,62320,53188,115508,63821,ทข.ดินแดง
8,38859,45038,83897,31653,ทข.ดุสิต
9,55226,48391,103617,42898,ทข.ตลิ่งชัน
10,42256,36493,78749,34420,ทข.ทวีวัฒนา
11,65673,58027,123700,54595,ทข.ทุ่งครุ
12,54983,48394,103377,57707,ทข.ธนบุรี
13,54691,49100,103791,50652,ทข.บางกอกน้อย
14,33874,29987,63861,32258,ทข.บางกอกใหญ่
15,78900,65832,144732,107103,ทข.บางกะปิ
16,98400,87744,186144,91013,ทข.บางขุนเทียน
17,43649,39084,82733,39812,ทข.บางคอแหลม
18,65471,56939,122410,76116,ทข.บางซื่อ
19,47555,40980,88535,72092,ทข.บางนา
20,54469,49897,104366,50825,ทข.บางบอน
21,48708,40709,89417,55838,ทข.บางพลัด
22,24230,21527,45757,32371,ทข.บางรัก
23,99379,87998,187377,114661,ทข.บางเขน
24,103527,89776,193303,94020,ทข.บางแค
25,76618,64199,140817,75943,ทข.บึงกุ่ม
26,23028,20310,43338,32590,ทข.ปทุมวัน
27,96478,85343,181821,92009,ทข.ประเวศ
28,21327,20197,41524,19627,ทข.ป้อมปราบศัตรูพ่าย
29,34272,33116,67388,44727,ทข.พญาไท
30,23248,21675,44923,19137,ทข.พระนคร
31,48243,39613,87856,60007,ทข.พระโขนง
32,66372,57946,124318,65843,ทข.ภาษีเจริญ
33,75097,67100,142197,61665,ทข.มีนบุรี
34,40920,35644,76564,53614,ทข.ยานนาวา
35,36127,33137,69264,52494,ทข.ราชเทวี
36,41200,37487,78687,37664,ทข.ราษฎร์บูรณะ
37,93840,85131,178971,98260,ทข.ลาดกระบัง
38,63876,53232,117108,57916,ทข.ลาดพร้าว
39,58405,49053,107458,62673,ทข.วังทองหลาง
40,43651,37972,81623,82407,ทข.วัฒนา
41,67110,56499,123609,81116,ทข.สวนหลวง
42,52034,44058,96092,41308,ทข.สะพานสูง
43,10957,10367,21324,13197,ทข.สัมพันธวงศ์
44,39907,35828,75735,43459,ทข.สาทร
45,110020,97252,207272,106139,ทข.สายไหม
46,91415,86564,177979,66754,ทข.หนองจอก
47,83319,72884,156203,62675,ทข.หนองแขม
48,53807,48897,102704,57833,ทข.หลักสี่
49,46519,37714,84233,85046,ทข.ห้วยขวาง
50,5549,4754,10303,5177,ทต.กกโก
51,2167,1952,4119,2016,ทต.กงไกรลาศ
52,2065,1772,3837,2193,ทต.กบินทร์
53,1869,1730,3599,1389,ทต.กม.5
54,5165,4651,9816,3618,ทต.กมลาไสย
55,1753,1728,3481,1272,ทต.กรอกสมบูรณ์
56,3763,3568,7331,1949,ทต.กระจัน
57,4104,3702,7806,3708,ทต.กระจับ
58,1183,1036,2219,851,ทต.กระดังงา
59,9251,8988,18239,8566,ทต.กระบี่น้อย
60,1787,1611,3398,1797,ทต.กระสัง
61,4467,4352,8819,2196,ทต.กระหวัน
62,949,861,1810,773,ทต.กระโสม
63,6719,6243,12962,3815,ทต.กรับใหญ่
64,2559,2462,5021,2665,ทต.กลางดง
65,2447,2391,4838,1831,ทต.กองดิน
66,4072,3661,7733,8500,ทต.กะรน
67,798,757,1555,666,ทต.กะเปอร์
68,3028,2699,5727,3380,ทต.กังแอน
69,4426,4585,9011,2236,ทต.กันทรอม
70,3145,2937,6082,3182,ทต.กันทรารมย์
71,4956,4583,9539,4674,ทต.กาญจนดิษฐ์
72,1329,1295,2624,1618,ทต.กำเนิดนพคุณ
73,1399,1306,2705,1327,ทต.กำแพง
74,2629,2380,5009,2834,ทต.กำแพง
75,1142,1052,2194,823,ทต.กำแพงดิน
76,2540,2373,4913,2550,ทต.กำแพงเพชร
77,3600,3240,6840,4177,ทต.กำแพงแสน
78,2036,2100,4136,1454,ทต.กุดข้าวปุ้น
79,5300,4954,10254,3849,ทต.กุดจับ
80,1394,1253,2647,1257,ทต.กุดจิก
81,5839,5903,11742,4337,ทต.กุดชมภู
82,2476,2370,4846,2162,ทต.กุดชุมพัฒนา
83,2866,2775,5641,1812,ทต.กุดดินจี่
84,1381,1386,2767,739,ทต.กุดดู่
85,3028,2859,5887,2566,ทต.กุดนกเปล้า
86,4316,4167,8483,2551,ทต.กุดน้ำใส
87,2643,2480,5123,1845,ทต.กุดบาก
88,6714,6908,13622,5015,ทต.กุดประทาย
89,5283,4991,10274,4467,ทต.กุดสิม
90,2723,2526,5249,2052,ทต.กุดหว้า
91,4260,3955,8215,4457,ทต.กุมภวาปี
92,4588,4205,8793,4194,ทต.กุยบุรี
93,2097,1968,4065,1689,ทต.กุสุมาลย์
94,2365,2271,4636,1578,ทต.กู่กาสิงห์
95,2219,2205,4424,2412,ทต.ขนอม
96,4566,4434,9000,2200,ทต.ขวาว
97,4186,3924,8110,3403,ทต.ขาณุวรลักษบุรี
98,2143,2097,4240,2128,ทต.ขามทะเลสอ
99,4735,4828,9563,3156,ทต.ขามป้อม
100,2689,2445,5134,1892,ทต.ขามสะแกแสง
101,9848,6663,16511,5518,ทต.ขามเรียง
102,20404,18642,39046,19877,ทต.ขามใหญ่
103,9099,7226,16325,11181,ทต.ขุนทะเล
104,2719,2687,5406,1829,ทต.ขุนพัดเพ็ง
105,1774,1703,3477,1709,ทต.ขุนยวม
106,5494,5362,10856,3718,ทต.ขุนหาญ
107,696,657,1353,652,ทต.คชสิทธิ์
108,3178,3196,6374,2674,ทต.ครึ่ง
109,1027,953,1980,1019,ทต.คลองขลุง
110,9815,10554,20369,9086,ทต.คลองขุด
111,4936,4403,9339,5310,ทต.คลองจิก
112,4723,4777,9500,3342,ทต.คลองชะอุ่น
113,5781,5609,11390,3174,ทต.คลองด่าน
114,2496,2226,4722,6486,ทต.คลองตำหรุ
115,1828,1690,3518,1779,ทต.คลองท่อมใต้
116,1160,1095,2255,1325,ทต.คลองปาง
117,1491,1398,2889,1288,ทต.คลองพน
118,3045,2884,5929,2229,ทต.คลองพิไกร
119,11509,11130,22639,8484,ทต.คลองลานพัฒนา
120,2292,2148,4440,1839,ทต.คลองวาฬ
121,1539,1461,3000,851,ทต.คลองสวน
122,1951,1793,3744,1709,ทต.คลองเต็ง
123,4199,4071,8270,3415,ทต.คลองแงะ
124,3011,2847,5858,2428,ทต.คลองแม่ลาย
125,5556,5045,10601,4390,ทต.คลองโยง
126,2663,2652,5315,2069,ทต.คลองใหญ่
127,2710,2623,5333,2440,ทต.คลองใหญ่
128,1712,2017,3729,1738,ทต.คลองไผ่
129,1118,1060,2178,747,ทต.ควนกุน
130,1138,1018,2156,1176,ทต.ควนขนุน
131,2228,1942,4170,1753,ทต.ควนเนียง
132,2719,2707,5426,1925,ทต.ควนโดน
133,731,768,1499,584,ทต.คอกช้าง
134,2252,2005,4257,1885,ทต.คอนสวรรค์
135,2218,2024,4242,1428,ทต.คอนสาร
136,6534,6681,13215,4084,ทต.คอแลน
137,1203,1182,2385,1126,ทต.คำชะอี
138,3716,3598,7314,2274,ทต.คำตากล้า
139,4037,3982,8019,3144,ทต.คำน้ำแซบ
140,5193,5265,10458,2975,ทต.คำบง
141,7017,6819,13836,4108,ทต.คำบ่อ
142,2117,2087,4204,2053,ทต.คำพราน
143,4601,4687,9288,2596,ทต.คำพอุง
144,1998,1938,3936,1684,ทต.คำม่วง
145,6363,6438,12801,4615,ทต.คำอาฮวน
146,1956,1901,3857,1547,ทต.คำเขื่อนแก้ว
147,2535,2470,5005,1601,ทต.คำใหญ่
148,1756,1711,3467,2121,ทต.คุระบุรี
149,4566,4273,8839,3468,ทต.คุ้งตะเภา
150,954,911,1865,988,ทต.คุ้งสำเภา
151,5773,5674,11447,3155,ทต.คูเต่า
152,1788,1804,3592,1939,ทต.คูเมือง
153,2299,2206,4505,1608,ทต.ค้อวัง
154,3411,3337,6748,2474,ทต.งิม
155,2083,1792,3875,1571,ทต.จตุรพักตรพิมาน
156,3246,2905,6151,2379,ทต.จระเข้หิน
157,4152,4368,8520,2354,ทต.จริม
158,2470,2548,5018,1509,ทต.จอมทอง
159,4978,4294,9272,4522,ทต.จอมทอง
160,2613,2277,4890,3588,ทต.จอมบึง
161,2180,1970,4150,1916,ทต.จอมพระ
162,350,345,695,433,ทต.จอมพลเจ้าพระยา
163,8428,8272,16700,9676,ทต.จอหอ
164,3500,3384,6884,3292,ทต.จะนะ
165,2175,1902,4077,1590,ทต.จักราช
166,2201,1961,4162,2187,ทต.จัตุรัส
167,7553,6745,14298,6155,ทต.จันจว้า
168,3843,3467,7310,3967,ทต.จันดี
169,5314,5224,10538,2916,ทต.จันดุม
170,3928,3914,7842,2377,ทต.จันทบเพชร
171,4050,4160,8210,2172,ทต.จำปี
172,4710,4425,9135,3919,ทต.จุน
173,4832,4770,9602,2463,ทต.จุมจัง
174,1222,1136,2358,996,ทต.ฉลุง
175,1263,1220,2483,1279,ทต.ฉวาง
176,4249,3794,8043,3299,ทต.ชนบท
177,1660,1753,3413,1824,ทต.ชนแดน
178,3927,3602,7529,3067,ทต.ชมภู
179,3690,3620,7310,2237,ทต.ชะรัด
180,1883,1627,3510,1658,ทต.ชะอวด
181,4357,3633,7990,2671,ทต.ชัยนาท
182,2699,2601,5300,1657,ทต.ชัยวารี
183,2220,2111,4331,1867,ทต.ชากไทย
184,1665,1535,3200,1420,ทต.ชานุมาน
185,4124,4811,8935,3530,ทต.ชุมพล
186,1234,1106,2340,1085,ทต.ชุมพลบุรี
187,4567,4328,8895,3799,ทต.ชุมพวง
188,1893,1855,3748,2230,ทต.ชุมแสง
189,2865,2868,5733,1770,ทต.ช่องลม
190,1872,1822,3694,1879,ทต.ช่องเม็ก
191,1579,1466,3045,1062,ทต.ช่องแค
192,4612,4312,8924,3640,ทต.ช่อแฮ
193,5595,5493,11088,3889,ทต.ช้างซ้าย
194,4759,4227,8986,8888,ทต.ช้างเผือก
195,4414,4233,8647,5058,ทต.ซับสมอทอด
196,2700,2579,5279,1907,ทต.ซำสูง
197,1366,1238,2604,1021,ทต.ดงขุย
198,2425,2342,4767,1607,ทต.ดงป่าคำ
199,3130,2817,5947,2258,ทต.ดงมะไฟ
200,4395,3912,8307,3554,ทต.ดงเจน
201,5279,5448,10727,3039,ทต.ดงเย็น
202,4489,4285,8774,2407,ทต.ดงแดง
203,831,776,1607,730,ทต.ดอนฉิมพลี
204,1381,1187,2568,952,ทต.ดอนตาล
205,3747,3406,7153,3093,ทต.ดอนทราย
206,2378,2318,4696,1817,ทต.ดอนพุด
207,3377,3131,6508,2186,ทต.ดอนยายหอม
208,2583,2541,5124,1484,ทต.ดอนหญ้านาง
209,1892,1714,3606,1278,ทต.ดอนหวาย
210,6615,6493,13108,14699,ทต.ดอนหัวฬ่อ
211,4285,4400,8685,2356,ทต.ดอนเกาะกา
212,2113,2086,4199,1241,ทต.ดอนเขือง
213,1508,1433,2941,1365,ทต.ดอนเจดีย์
214,1769,1705,3474,1804,ทต.ดอนโมง
215,2282,2015,4297,2128,ทต.ดอยสะเก็ด
216,3858,3376,7234,3216,ทต.ดำเนินสะดวก
217,3495,3402,6897,1992,ทต.ดินดำ
218,4183,3905,8088,3739,ทต.ดีลัง
219,3233,2873,6106,3936,ทต.ด่านขุนทด
220,4358,4197,8555,2567,ทต.ด่านคล้า
221,3293,3027,6320,3341,ทต.ด่านช้าง
222,1740,1678,3418,1932,ทต.ด่านซ้าย
223,1212,1241,2453,825,ทต.ด่านทับตะโก
224,1257,1238,2495,1255,ทต.ด่านมะขามเตี้ย
225,29230,25688,54918,25203,ทต.ด่านสำโรง
226,5004,4776,9780,4295,ทต.ด่านเกวียน
227,2148,2006,4154,1584,ทต.ตกพรม
228,869,811,1680,675,ทต.ตรอน
229,4627,4426,9053,4307,ทต.ตระการพืชผล
230,2456,2328,4784,1726,ทต.ตลาดนิคมปราสาท
231,2173,1929,4102,1789,ทต.ตลาดเขต
232,1738,1581,3319,1313,ทต.ตลาดแค
233,2802,2485,5287,2930,ทต.ตลาดไชยา
234,5802,5494,11296,3634,ทต.ตลุกดู่
235,6388,6223,12611,5651,ทต.ตองโขบ
236,1338,1273,2611,1334,ทต.ตะกาง
237,2405,2352,4757,2189,ทต.ตะกุด
238,2688,2571,5259,1874,ทต.ตะขบ
239,2863,2645,5508,1909,ทต.ตะค่า
240,2269,2321,4590,1814,ทต.ตะเคียนทอง
241,12544,11647,24191,12241,ทต.ตะเคียนเตี้ย
242,2209,2120,4329,1549,ทต.ตะโหมด
243,1485,1321,2806,730,ทต.ตันหยง
244,3652,3402,7054,3808,ทต.ตันหยงมัส
245,2828,2644,5472,2738,ทต.ตากฟ้า
246,8229,8355,16584,4309,ทต.ตาจง
247,1337,1307,2644,1145,ทต.ตาพระยา
248,1633,1604,3237,1066,ทต.ตาลสุม
249,1840,1878,3718,878,ทต.ตาลเลียน
250,2890,2616,5506,2025,ทต.ต้นคราม
251,2564,2338,4902,1354,ทต.ต้นไทร
252,5022,5996,11018,4730,ทต.ถนนใหญ่
253,4568,4180,8748,3405,ทต.ถอนสมอ
254,3841,3812,7653,2175,ทต.ถาวร
255,5724,5602,11326,6318,ทต.ทรายขาว
256,3223,3047,6270,2094,ทต.ทรายมูล
257,1513,1582,3095,1569,ทต.ทองผาภูมิ
258,2351,2218,4569,1807,ทต.ทองแสนขัน
259,1710,1719,3429,1050,ทต.ทอนหงส์
260,2206,2175,4381,1247,ทต.ทะเมนชัย
261,1134,1028,2162,820,ทต.ทับกฤช
262,2321,2127,4448,1753,ทต.ทับคล้อ
263,8113,8260,16373,6030,ทต.ทับช้าง
264,528,497,1025,650,ทต.ทับปุด
265,12562,12460,25022,16938,ทต.ทับมา
266,3463,3128,6591,3462,ทต.ทับสะแก
267,4635,4216,8851,3614,ทต.ทัพทัน
268,1565,1412,2977,1394,ทต.ทากาศ
269,4358,4532,8890,2846,ทต.ทางพูน
270,2541,2417,4958,2261,ทต.ทาสบชัย
271,2756,2581,5337,2510,ทต.ทาสบเส้า
272,7086,7106,14192,6364,ทต.ที่วัง
273,3045,2989,6034,2101,ทต.ทุ่งกระเชาะ
274,5388,5454,10842,3033,ทต.ทุ่งข้าวพวง
275,3451,3188,6639,3922,ทต.ทุ่งควายกิน
276,1789,1542,3331,1260,ทต.ทุ่งคอก
277,1642,1709,3351,1419,ทต.ทุ่งช้าง
278,4490,4310,8800,3233,ทต.ทุ่งทราย
279,3772,3449,7221,2180,ทต.ทุ่งฝน
280,5224,4583,9807,4080,ทต.ทุ่งยั้ง
281,1317,1147,2464,1092,ทต.ทุ่งยาว
282,3785,3571,7356,2499,ทต.ทุ่งลาน
283,2313,3063,5376,3987,ทต.ทุ่งสะเดา
284,3722,3414,7136,2382,ทต.ทุ่งหลวง
285,6899,6870,13769,4296,ทต.ทุ่งหลวง
286,5810,5495,11305,4164,ทต.ทุ่งหลวง
287,1653,1586,3239,1231,ทต.ทุ่งหว้า
288,1264,1263,2527,1217,ทต.ทุ่งหัวช้าง
289,3925,3492,7417,3018,ทต.ทุ่งเสลี่ยม
290,3255,2856,6111,3139,ทต.ทุ่งโฮ้ง
291,962,965,1927,1095,ทต.ท่าขนอน
292,4601,4257,8858,6327,ทต.ท่าขอนยาง
293,3963,3667,7630,8858,ทต.ท่าข้าม
294,1239,1253,2492,968,ทต.ท่าข้าม
295,690,706,1396,661,ทต.ท่าข้าม
296,2989,2759,5748,3461,ทต.ท่าข้าม
297,4598,4536,9134,2898,ทต.ท่าคันโท
298,2466,2300,4766,1923,ทต.ท่าฉาง
299,1531,1381,2912,1746,ทต.ท่าชนะ
300,485,483,968,332,ทต.ท่าช้าง
301,2603,2418,5021,2056,ทต.ท่าช้าง
302,11139,10971,22110,9709,ทต.ท่าช้าง
303,2992,2639,5631,2878,ทต.ท่าตะโก
304,2105,1986,4091,1797,ทต.ท่าตูม
305,3573,3481,7054,3112,ทต.ท่าทองใหม่
306,539,503,1042,590,ทต.ท่านา
307,2631,2428,5059,2737,ทต.ท่าน้ำอ้อยม่วงหัก
308,3481,3281,6762,4145,ทต.ท่าบุญมี
309,1200,1091,2291,930,ทต.ท่าปลา
310,4684,4269,8953,4036,ทต.ท่าพระ
311,3449,3185,6634,2996,ทต.ท่าพริกเนินทราย
312,3990,3647,7637,2570,ทต.ท่าพล
313,767,754,1521,625,ทต.ท่าพุทรา
314,4606,4027,8633,4687,ทต.ท่ามะกา
315,1860,1745,3605,2024,ทต.ท่ามะเขือ
316,2161,2009,4170,1785,ทต.ท่ามะเดื่อ
317,5375,4657,10032,5460,ทต.ท่าม่วง
318,14713,13283,27996,11452,ทต.ท่ายาง
319,5206,5041,10247,4663,ทต.ท่ายาง
320,2713,2450,5163,3021,ทต.ท่ายาง
321,4872,4122,8994,4993,ทต.ท่าระหัด
322,4094,3809,7903,3996,ทต.ท่าลาน
323,1042,956,1998,815,ทต.ท่าลี่
324,4759,4308,9067,3878,ทต.ท่าล้อ
325,7632,8094,15726,9546,ทต.ท่าวังทอง
326,2686,2475,5161,2700,ทต.ท่าวังผา
327,1125,1023,2148,910,ทต.ท่าวุ้ง
328,7800,6913,14713,7083,ทต.ท่าศาลา
329,1521,1347,2868,1771,ทต.ท่าศาลา
330,3777,3251,7028,5433,ทต.ท่าศาลา
331,3495,3402,6897,1993,ทต.ท่าสะอาด
332,1665,1533,3198,2428,ทต.ท่าสะอ้าน
333,629,574,1203,567,ทต.ท่าสัก
334,11889,12655,24544,4641,ทต.ท่าสายลวด
335,4464,3959,8423,4118,ทต.ท่าหลวง
336,1665,1536,3201,1194,ทต.ท่าฬ่อ
337,2498,2341,4839,1947,ทต.ท่าอุเทน
338,1901,1710,3611,1602,ทต.ท่าเกษม
339,2202,2091,4293,1859,ทต.ท่าเดื่อ-มืดกา
340,5678,5533,11211,5332,ทต.ท่าเยี่ยม
341,3468,3060,6528,3174,ทต.ท่าเรือ
342,7184,6747,13931,4361,ทต.ท่าเสด็จ
343,7123,7568,14691,7454,ทต.ท่าเสา
344,738,749,1487,524,ทต.ท่าเสา
345,1076,958,2034,1355,ทต.ท่าแซะ
346,2044,1970,4014,1286,ทต.ท่าแพ
347,3484,3230,6714,2323,ทต.ท่าแร่
348,3232,2979,6211,2158,ทต.ท่าแลง
349,1217,1060,2277,994,ทต.ท่าโขลง
350,4731,4444,9175,3847,ทต.ท่าไม้
351,2793,2783,5576,3253,ทต.ท้องเนียน
352,1785,1682,3467,1061,ทต.ท้ายดง
353,1719,1599,3318,1744,ทต.ท้ายเหมือง
354,8158,7685,15843,5812,ทต.ท้าวอู่ทอง
355,4015,3759,7774,2490,ทต.ธงธานี
356,3643,3296,6939,2970,ทต.ธรรมศาลา
357,3232,3116,6348,1699,ทต.ธัญญา
358,33108,29962,63070,33989,ทต.ธัญบุรี
359,4917,4868,9785,3364,ทต.ธาตุ
360,4000,3869,7869,2721,ทต.ธาตุทอง
361,5157,4874,10031,4113,ทต.ธาตุพนม
362,4427,3756,8183,5052,ทต.นครชัยศรี
363,3653,3237,6890,3454,ทต.นครชุม
364,3650,3319,6969,3027,ทต.นครหลวง
365,780,695,1475,496,ทต.นครเนื่องเขต
366,4661,4375,9036,4088,ทต.นครไทย
367,10266,9947,20213,6601,ทต.นากลาง
368,6541,6422,12963,3366,ทต.นาขาม
369,3315,3126,6441,2565,ทต.นาข่า
370,2518,2479,4997,1427,ทต.นาคำไฮ
371,2773,2551,5324,1913,ทต.นาคู
372,2260,2114,4374,1624,ทต.นางบวช
373,3982,3597,7579,2570,ทต.นางลือ
374,4605,4500,9105,3410,ทต.นางัว
375,6792,6067,12859,5647,ทต.นางั่ว
376,6062,5586,11648,5737,ทต.นางแล
377,4237,3789,8026,15653,ทต.นาจอมเทียน
378,3638,3668,7306,2637,ทต.นาจะหลวย
379,4259,4228,8487,2493,ทต.นาจารย์
380,4933,5069,10002,3021,ทต.นาดอกคำ
381,5306,5354,10660,3665,ทต.นาดินดำ
382,4022,3900,7922,3306,ทต.นาดี
383,14813,13282,28095,16548,ทต.นาดี
384,2346,2388,4734,1773,ทต.นาดูน
385,3344,3329,6673,2355,ทต.นาด้วง
386,3254,3215,6469,3683,ทต.นาทวี
387,7046,7205,14251,3676,ทต.นาทัน
388,1279,1137,2416,1221,ทต.นาน้อย
389,1159,1120,2279,1139,ทต.นาบอน
390,1608,1509,3117,1403,ทต.นาประดู่
391,21052,20301,41353,25817,ทต.นาป่า
392,3506,3496,7002,2335,ทต.นามน
393,2143,2002,4145,1081,ทต.นามะเฟือง
394,2650,2593,5243,1542,ทต.นายม
395,9774,9108,18882,7030,ทต.นายาง
396,1844,1686,3530,1959,ทต.นายายอาม
397,2079,1966,4045,1792,ทต.นาวง
398,1534,1381,2915,1107,ทต.นาสีทอง
399,1629,1520,3149,985,ทต.นาส่วง
400,5629,5263,10892,3278,ทต.นาหนองทุ่ม
401,6174,6019,12193,4195,ทต.นาหว้า
402,6447,6261,12708,5783,ทต.นาอาน
403,3131,2968,6099,2231,ทต.นาอ้อ
404,2231,2031,4262,1731,ทต.นาเฉลียง
405,1941,1843,3784,2069,ทต.นาเชือก
406,3313,3210,6523,1833,ทต.นาเยีย
407,3553,3378,6931,2420,ทต.นาเหล่า
408,2320,2064,4384,2327,ทต.นาแก
409,4558,4373,8931,3104,ทต.นาแก้ว
410,984,1031,2015,888,ทต.นาแห้ว
411,5166,5096,10262,3452,ทต.นาโป่ง
412,1903,1770,3673,1636,ทต.นาโพธิ์
413,1565,1375,2940,1676,ทต.นาโพธิ์
414,1849,1674,3523,1551,ทต.นาโยงเหนือ
415,3186,3060,6246,2305,ทต.นิคมคำสร้อย
416,4693,4511,9204,3613,ทต.นิคมทุ่งโพธิ์ทะเล
417,1354,1331,2685,849,ทต.นิคมปราสาท
418,1913,1801,3714,1296,ทต.นิคมสงเคราะห์
419,3399,3330,6729,3013,ทต.นิเวศน์
420,5341,5178,10519,3000,ทต.น้ำคำ
421,1854,1820,3674,1918,ทต.น้ำจืด
422,1991,1935,3926,1572,ทต.น้ำตกไทรโยคน้อย
423,7814,6972,14786,6044,ทต.น้ำน้อย
424,1958,1823,3781,1234,ทต.น้ำปลีก
425,1552,1394,2946,1581,ทต.น้ำปาด
426,2564,2386,4950,2433,ทต.น้ำพอง
427,4546,4490,9036,3378,ทต.น้ำยืน
428,3504,3394,6898,2579,ทต.น้ำริด
429,1815,1769,3584,1215,ทต.น้ำสวย
430,1701,1589,3290,1333,ทต.น้ำเชี่ยว
431,4897,4732,9629,3495,ทต.น้ำโจ้
432,4417,4254,8671,2547,ทต.น้ำโสม
433,5049,5134,10183,2955,ทต.บงใต้
434,3056,2615,5671,2320,ทต.บรบือ
435,2016,1839,3855,1828,ทต.บรรพตพิสัย
436,4470,4067,8537,3874,ทต.บวกค้าง
437,1300,1311,2611,979,ทต.บันนังสตา
438,3918,3903,7821,2436,ทต.บัลลังก์
439,3358,3382,6740,1854,ทต.บัวงาม
440,6660,6333,12993,4429,ทต.บัวบาน
441,2940,2951,5891,1885,ทต.บัววัฒนา
442,3291,3199,6490,2381,ทต.บัวเชด
443,7261,6276,13537,8744,ทต.บางกระทึก
444,709,683,1392,615,ทต.บางกระทุ่ม
445,6999,6163,13162,5629,ทต.บางกระสั้น
446,2638,2474,5112,2164,ทต.บางกะจะ
447,996,919,1915,584,ทต.บางกุ้ง
448,1038,1046,2084,782,ทต.บางขนาก
449,4990,4291,9281,4853,ทต.บางคล้า
450,3998,3670,7668,2777,ทต.บางจัก
451,952,865,1817,659,ทต.บางจาก
452,2680,2568,5248,1831,ทต.บางซ้าย
453,2633,2504,5137,1862,ทต.บางตะบูน
454,5246,6433,11679,7448,ทต.บางทราย
455,948,794,1742,853,ทต.บางนกแขวก
456,3957,3550,7507,4080,ทต.บางนมโค
457,1781,1625,3406,1362,ทต.บางน้ำเชี่ยว
458,1203,1152,2355,1188,ทต.บางน้ำเปรี้ยว
459,5793,5219,11012,3713,ทต.บางบาล
460,3362,3083,6445,2331,ทต.บางบ่อ
461,2552,2469,5021,1565,ทต.บางประมุง
462,3604,3358,6962,4327,ทต.บางปลา
463,990,938,1928,662,ทต.บางปลาม้า
464,3232,2926,6158,2903,ทต.บางปะกง
465,2795,2495,5290,2219,ทต.บางปะหัน
466,3454,3353,6807,2193,ทต.บางปะอิน
467,61898,57602,119500,59612,ทต.บางปู
468,5230,5183,10413,2257,ทต.บางปู
469,6986,6394,13380,7709,ทต.บางพระ
470,5831,5068,10899,5979,ทต.บางพลับ
471,5934,5903,11837,2197,ทต.บางพลี
472,13615,12168,25783,19879,ทต.บางพูน
473,3107,2994,6101,2753,ทต.บางม่วง
474,2249,2030,4279,1975,ทต.บางระกำ
475,6524,5960,12484,8982,ทต.บางละมุง
476,1550,1422,2972,1956,ทต.บางวัว
477,5783,5298,11081,8208,ทต.บางวัวคณารักษ์
478,2027,2012,4039,1929,ทต.บางสวรรค์
479,1492,1461,2953,1503,ทต.บางสะพานน้อย
480,2844,2537,5381,2610,ทต.บางหลวง
481,1090,1018,2108,769,ทต.บางหลวง
482,3729,3404,7133,4485,ทต.บางหลวง
483,5631,5342,10973,4494,ทต.บางเตย
484,53123,46603,99726,50039,ทต.บางเมือง
485,4221,4216,8437,4094,ทต.บางเลน
486,6257,5331,11588,9206,ทต.บางเสร่
487,11349,10405,21754,17089,ทต.บางเสาธง
488,1933,1865,3798,1421,ทต.บางแก้ว
489,8418,7691,16109,6461,ทต.บางแพ
490,6259,5824,12083,5813,ทต.บางใหญ่
491,5230,5017,10247,3779,ทต.บางไทร
492,797,719,1516,627,ทต.บางไผ่
493,4760,4758,9518,2277,ทต.บาเจาะ
494,3625,3352,6977,2964,ทต.บำเหน็จณรงค์
495,3157,3004,6161,1803,ทต.บึงบูรพ์
496,2276,2125,4401,1676,ทต.บึงระมาณ
497,4930,4847,9777,3335,ทต.บึงโขงหลง
498,3072,2920,5992,2513,ทต.บุญเรือง
499,2261,2194,4455,2064,ทต.บุณฑริก
500,5075,5206,10281,2769,ทต.บุสูง
501,2575,2467,5042,1381,ทต.บูเก๊ะตา
502,3687,3528,7215,2623,ทต.บ่อ
503,1051,927,1978,741,ทต.บ่อกรุ
504,5659,5447,11106,3472,ทต.บ่อตรุ
505,6323,10194,16517,5868,ทต.บ่อทอง
506,2151,2090,4241,2041,ทต.บ่อทอง
507,4396,4367,8763,5648,ทต.บ่อพลอย
508,3512,3468,6980,2703,ทต.บ่อพลอย
509,5010,4535,9545,4770,ทต.บ่อพลับ
510,6030,6096,12126,3829,ทต.บ่อหลวง
511,2074,2300,4374,2511,ทต.บ่อเวฬุ
512,4793,4290,9083,4123,ทต.บ่อแฮ้ว
513,4894,4722,9616,2983,ทต.บ่อไทย
514,2003,1952,3955,1953,ทต.บ้านกรวด
515,4666,4658,9324,2677,ทต.บ้านกรวดปัญญาวัฒน์
516,2189,1981,4170,2294,ทต.บ้านกรูด
517,6131,5263,11394,11061,ทต.บ้านกลาง
518,6538,5863,12401,6357,ทต.บ้านกลาง
519,5456,4828,10284,5320,ทต.บ้านกลาง
520,3661,3296,6957,3493,ทต.บ้านกล้วย
521,8535,7593,16128,7105,ทต.บ้านกล้วย
522,1756,1568,3324,2022,ทต.บ้านค่าย
523,2535,2413,4948,1894,ทต.บ้านค่ายหมื่นแผ้ว
524,8563,8364,16927,6665,ทต.บ้านค้อ
525,4531,4111,8642,3433,ทต.บ้านฆ้อง
526,3759,3261,7020,3324,ทต.บ้านจั่น
527,7320,7095,14415,8481,ทต.บ้านฉาง
528,1946,1961,3907,1875,ทต.บ้านชัฏป่าหวาย
529,3933,3699,7632,2037,ทต.บ้านดอน
530,10753,9497,20250,13899,ทต.บ้านดู่
531,6134,5891,12025,3271,ทต.บ้านด่าน
532,1967,1901,3868,1378,ทต.บ้านด่านนาขาม
533,1446,1469,2915,1304,ทต.บ้านด่านโขงเจียม
534,3520,3048,6568,2700,ทต.บ้านตาก
535,1228,1168,2396,1801,ทต.บ้านตาขุน
536,3157,2953,6110,2245,ทต.บ้านต้า
537,3657,3443,7100,3221,ทต.บ้านต๊ำ
538,6793,5797,12590,7205,ทต.บ้านต๋อม
539,4083,4164,8247,3180,ทต.บ้านถ้ำ
540,1955,1930,3885,2097,ทต.บ้านท่าหลวง
541,8585,8335,16920,5103,ทต.บ้านธาตุ
542,4961,4525,9486,4289,ทต.บ้านธิ
543,4305,4128,8433,3329,ทต.บ้านนา
544,2609,2336,4945,2489,ทต.บ้านนา
545,1699,1585,3284,1638,ทต.บ้านนา
546,3804,3725,7529,3053,ทต.บ้านนา
547,1115,1124,2239,783,ทต.บ้านนาปรือ
548,1335,1205,2540,1172,ทต.บ้านนิเวศน์
549,2936,2629,5565,4522,ทต.บ้านปลวกแดง
550,2073,1962,4035,1592,ทต.บ้านปล้อง
551,1226,1024,2250,820,ทต.บ้านปิน
552,3921,3677,7598,4025,ทต.บ้านผือ
553,2373,2258,4631,1820,ทต.บ้านฝาง
554,3502,3528,7030,2844,ทต.บ้านพราน
555,3474,3477,6951,2566,ทต.บ้านมุง
556,1846,1714,3560,1480,ทต.บ้านม่วง
557,572,483,1055,383,ทต.บ้านยาง
558,1981,1696,3677,1655,ทต.บ้านลาด
559,5763,5007,10770,7091,ทต.บ้านสร้าง
560,1654,1595,3249,1616,ทต.บ้านสร้าง
561,2301,2073,4374,1703,ทต.บ้านสวน
562,6331,5772,12103,4488,ทต.บ้านสิงห์
563,8907,8738,17645,6817,ทต.บ้านส้อง
564,1383,1301,2684,1342,ทต.บ้านหมอ
565,4848,4283,9131,3756,ทต.บ้านเกาะ
566,4211,3818,8029,3360,ทต.บ้านเขว้า
567,2987,2962,5949,1960,ทต.บ้านเชียง
568,2257,2290,4547,1948,ทต.บ้านเชี่ยวหลาน
569,7827,7698,15525,4496,ทต.บ้านเดื่อ
570,24104,21162,45266,26853,ทต.บ้านเป็ด
571,3936,3786,7722,2329,ทต.บ้านเป้า
572,9308,8461,17769,11923,ทต.บ้านเพ
573,2518,2397,4915,2204,ทต.บ้านเพชร
574,2855,2780,5635,1733,ทต.บ้านเพชรภูเขียว
575,5613,5141,10754,4948,ทต.บ้านเลือก
576,9521,9777,19298,7725,ทต.บ้านเสด็จ
577,1825,1617,3442,1204,ทต.บ้านเหลื่อม
578,3989,3845,7834,2938,ทต.บ้านเหล่า
579,2028,2019,4047,1692,ทต.บ้านเหล่า
580,1107,1000,2107,880,ทต.บ้านแก่ง
581,1558,1526,3084,929,ทต.บ้านแก้ง
582,2076,1991,4067,1614,ทต.บ้านแท่น
583,3344,2898,6242,2733,ทต.บ้านแป้น
584,4468,4345,8813,3567,ทต.บ้านแพง
585,1041,964,2005,875,ทต.บ้านแพรก
586,1669,1538,3207,1056,ทต.บ้านแพ้ว
587,971,942,1913,889,ทต.บ้านแม่ข่า
588,4883,5052,9935,4877,ทต.บ้านแยง
589,602,596,1198,446,ทต.บ้านแหลม
590,6080,5651,11731,4212,ทต.บ้านแหลม
591,3392,3311,6703,2234,ทต.บ้านแฮด
592,4580,4445,9025,2998,ทต.บ้านโข้ง
593,3297,3003,6300,1865,ทต.บ้านโคก
594,1922,1948,3870,1876,ทต.บ้านโคก
595,2143,1984,4127,1424,ทต.บ้านโคก
596,1607,1425,3032,1602,ทต.บ้านโตนด
597,3380,3130,6510,2013,ทต.บ้านโต้น
598,1441,1392,2833,1409,ทต.บ้านโพธิ์
599,4142,3558,7700,3607,ทต.บ้านโฮ่ง
600,1286,1284,2570,879,ทต.บ้านใหม่
601,1019,916,1935,790,ทต.บ้านใหม่
602,2198,2105,4303,1405,ทต.บ้านใหม่ไชยพจน์
603,1300,1251,2551,1391,ทต.บ้านไร่
604,4104,3931,8035,3384,ทต.บ้านไร่
605,2966,2690,5656,2800,ทต.ปง
606,5540,4995,10535,4099,ทต.ปทุม
607,3288,3073,6361,2116,ทต.ปทุมรัตต์
608,1760,1722,3482,1694,ทต.ปทุมราชวงศา
609,2388,2148,4536,2367,ทต.ประจันตคาม
610,3138,2960,6098,3041,ทต.ประทาย
611,5092,4558,9650,4083,ทต.ประโคนชัย
612,1399,1339,2738,1204,ทต.ปรางค์กู่
613,8674,7942,16616,9308,ทต.ปราณบุรี
614,2438,2204,4642,2996,ทต.ปราสาททอง
615,3251,3119,6370,2011,ทต.ปริก
616,5134,4706,9840,5106,ทต.ปรุใหญ่
617,1875,1699,3574,1303,ทต.ปลักแรด
618,2020,1909,3929,1566,ทต.ปลาปาก
619,4333,3982,8315,2873,ทต.ปลายนา
620,25017,21338,46355,23299,ทต.ปลายบาง
621,3023,3036,6059,2478,ทต.ปลายพระยา
622,3793,3481,7274,2421,ทต.ปอภาร
623,3613,3517,7130,2730,ทต.ปะคำ
624,736,635,1371,874,ทต.ปะทิว
625,5246,5303,10549,2642,ทต.ปะนาเระ
626,3588,3475,7063,2085,ทต.ปะลุรู
627,5650,5637,11287,3398,ทต.ปะโค
628,5408,5045,10453,4844,ทต.ปัว
629,3344,3355,6699,2701,ทต.ปากคาด
630,1780,1687,3467,1540,ทต.ปากชม
631,1706,1567,3273,1324,ทต.ปากดง
632,2014,2084,4098,1621,ทต.ปากตะโก
633,1471,1381,2852,1389,ทต.ปากท่อ
634,3129,3167,6296,2000,ทต.ปากนคร
635,2896,2660,5556,2579,ทต.ปากน้ำ
636,2361,2153,4514,1758,ทต.ปากน้ำ
637,1210,1343,2553,1753,ทต.ปากน้ำ
638,3297,3144,6441,3400,ทต.ปากน้ำชุมพร
639,2489,2320,4809,1978,ทต.ปากน้ำประแส
640,3904,3931,7835,3463,ทต.ปากน้ำปราณ
641,3293,3221,6514,3039,ทต.ปากน้ำหลังสวน
642,4515,4281,8796,3406,ทต.ปากน้ำแหลมสิงห์
643,1707,1576,3283,1523,ทต.ปากพะยูน
644,1845,1753,3598,1890,ทต.ปาย
645,6452,7555,14007,4468,ทต.ปิงโค้ง
646,4017,3726,7743,2767,ทต.ป่ากุมเกาะ
647,2214,2026,4240,1989,ทต.ป่าก่อดำ
648,4585,3902,8487,4141,ทต.ป่าซาง
649,6132,5469,11601,5548,ทต.ป่าซาง
650,4063,3802,7865,2967,ทต.ป่าตันนาครัว
651,1563,1511,3074,1209,ทต.ป่าติ้ว
652,1989,1932,3921,1714,ทต.ป่าบอน
653,6010,5353,11363,5324,ทต.ป่าอ้อดอนชัย
654,3879,3744,7623,3047,ทต.ป่าแงะ
655,2737,2619,5356,2564,ทต.ป่าแดง
656,3248,3109,6357,2408,ทต.ป่าแดด
657,9471,8096,17567,10832,ทต.ป่าแดด
658,6405,5638,12043,4899,ทต.ป่าแมต
659,4622,4276,8898,3593,ทต.ป่าโมก
660,7178,6473,13651,6053,ทต.ป่าไผ่
661,386,335,721,412,ทต.ป๊อกแป๊ก
662,4164,3929,8093,3029,ทต.ผาจุก
663,7770,8071,15841,4714,ทต.ผาสุก
664,4543,4295,8838,3756,ทต.ฝายกวาง
665,2193,2024,4217,2209,ทต.พญาเม็งราย
666,2450,2480,4930,1982,ทต.พนม
667,2756,2470,5226,2179,ทต.พนมทวน
668,6107,5729,11836,3849,ทต.พนมรุ้ง
669,3465,2992,6457,4216,ทต.พนมสารคาม
670,2139,2042,4181,1770,ทต.พนมไพร
671,1441,1293,2734,1104,ทต.พนา
672,3075,3275,6350,2702,ทต.พบพระ
673,4220,3820,8040,4178,ทต.พยัคฆภูมิพิสัย
674,3010,2601,5611,2965,ทต.พยุหะ
675,1973,1941,3914,1401,ทต.พยุห์
676,1286,1147,2433,1448,ทต.พรรณานิคม
677,1645,1528,3173,1301,ทต.พรหมบุรี
678,599,528,1127,544,ทต.พรหมพิราม
679,3440,3349,6789,2677,ทต.พรหมโลก
680,2085,1999,4084,1637,ทต.พระทองคำ
681,1195,1157,2352,1103,ทต.พระธาตุปู่ก่ำ
682,1730,1586,3316,1455,ทต.พระยืน
683,6150,5931,12081,5697,ทต.พระสมุทรเจดีย์
684,4949,4490,9439,6309,ทต.พระอินทราชา
685,3037,3019,6056,2144,ทต.พระเหลา
686,3219,2960,6179,2118,ทต.พระแท่น
687,4559,4187,8746,3667,ทต.พรานกระต่าย
688,5279,5056,10335,3484,ทต.พรเจริญ
689,3897,3620,7517,4128,ทต.พลวง
690,3276,3350,6626,1938,ทต.พลับพลาชัย
691,5466,4920,10386,6199,ทต.พลับพลานารายณ์
692,4607,4611,9218,5885,ทต.พลา
693,4043,3524,7567,4165,ทต.พลายชุมพล
694,3756,3320,7076,3086,ทต.พลิ้ว
695,4101,3625,7726,4737,ทต.พะตง
696,17693,16230,33923,15176,ทต.พะวง
697,741,739,1480,687,ทต.พะโต๊ะ
698,3280,3194,6474,3935,ทต.พังโคน
699,1723,1571,3294,1436,ทต.พัฒนานิคม
700,2925,2642,5567,2599,ทต.พันดอน
701,3074,3006,6080,2072,ทต.พันเสา
702,3257,3017,6274,3745,ทต.พานทอง
703,1412,1317,2729,1123,ทต.พิปูน
704,1747,1628,3375,3428,ทต.พิมพา
705,4232,3645,7877,2888,ทต.พิมาย
706,3463,3305,6768,2396,ทต.พุกร่าง
707,2225,2027,4252,2239,ทต.พุทไธสง
708,4034,3844,7878,2713,ทต.พุมเรียง
709,3773,3613,7386,3013,ทต.พุเตย
710,349,376,725,425,ทต.ฟากท่า
711,2429,2322,4751,1842,ทต.ฟ้าหยาด
712,3728,3237,6965,9486,ทต.ฟ้าฮ่าม
713,2838,2527,5365,2543,ทต.ภาชี
714,3640,3597,7237,2729,ทต.ภูกระดึง
715,1787,1701,3488,1276,ทต.ภูผาม่าน
716,4169,3974,8143,2338,ทต.ภูผาแดง
717,1368,1425,2793,819,ทต.ภูสิงห์
718,3343,2909,6252,3015,ทต.ภูเขียว
719,1413,1456,2869,1573,ทต.ภูเรือ
720,1564,1435,2999,1728,ทต.ภูเวียง
721,3537,3333,6870,3761,ทต.มวกเหล็ก
722,4405,4079,8484,3254,ทต.มหาพราหมณ์
723,1664,1567,3231,1437,ทต.มหาราช
724,2745,2455,5200,2342,ทต.มะกอก
725,1170,982,2152,790,ทต.มะกอกเหนือ
726,914,808,1722,1025,ทต.มะขาม
727,6872,6706,13578,11623,ทต.มะขามคู่
728,981,956,1937,586,ทต.มะค่า
729,4181,4242,8423,1758,ทต.มะรือโบตก
730,2747,2590,5337,2120,ทต.มะอึ
731,8322,7632,15954,8579,ทต.มะเขือแจ้
732,1906,1708,3614,1919,ทต.มัญจาคีรี
733,5313,5309,10622,8035,ทต.มาบข่า
734,4760,4688,9448,6773,ทต.มาบข่าพัฒนา
735,1907,1832,3739,2181,ทต.มาบอำมฤต
736,2420,2417,4837,1194,ทต.มายอ
737,2269,1963,4232,1984,ทต.ม่วงน้อย
738,1637,1496,3133,1586,ทต.ม่วงสามสิบ
739,5195,5059,10254,3491,ทต.ม่วงหวาน
740,2578,2466,5044,1337,ทต.ยะรัง
741,3068,3186,6254,1916,ทต.ยะหริ่ง
742,1220,1258,2478,759,ทต.ยะหา
743,3207,3127,6334,2387,ทต.ยางชุมน้อย
744,4478,4075,8553,3780,ทต.ยางตลาด
745,4673,4600,9273,2557,ทต.ยางหล่อ
746,5629,5410,11039,4003,ทต.ยางฮอม
747,5658,4723,10381,5388,ทต.ยางเนิ้ง
748,4300,4342,8642,2316,ทต.ยายแย้มวัฒนา
749,1537,1520,3057,1086,ทต.ยี่งอ
750,1258,1217,2475,1077,ทต.ย่านดินแดง
751,4176,3588,7764,3794,ทต.ย่านตาขาว
752,3701,3573,7274,3545,ทต.ระหาน
753,5429,4986,10415,5245,ทต.ระแหง
754,2364,2177,4541,1946,ทต.ระโนด
755,2798,2598,5396,2681,ทต.รัตนบุรี
756,25635,23061,48696,30382,ทต.รัษฎา
757,1103,1018,2121,683,ทต.รางกระทุ่ม
758,3623,3637,7260,2567,ทต.รางหวาย
759,3010,3000,6010,1804,ทต.ราชคราม
760,9962,8798,18760,19219,ทต.ราไวย์
761,2210,2009,4219,1561,ทต.รำมะสัก
762,3602,3177,6779,2898,ทต.ริมปิง
763,3825,3712,7537,3509,ทต.รือเสาะ
764,1636,1707,3343,1059,ทต.ร่มเกล้า
765,1788,1598,3386,1198,ทต.ร่วมจิต
766,3102,2972,6074,2169,ทต.ร่องคำ
767,3984,3880,7864,3359,ทต.ร่อนทอง
768,4013,3672,7685,3303,ทต.ร่อนพิบูลย์
769,6549,5906,12455,6031,ทต.ร้องกวาง
770,4131,4169,8300,3379,ทต.ละหานทราย
771,1315,1356,2671,1195,ทต.ละอุ่น
772,1592,1483,3075,1815,ทต.ละแม
773,3947,3703,7650,2754,ทต.ลาดชะโด
774,2181,1975,4156,2204,ทต.ลาดบัวขาว
775,1351,1300,2651,1414,ทต.ลาดบัวหลวง
776,3206,2843,6049,3478,ทต.ลาดยาว
777,2833,2655,5488,2324,ทต.ลาดหญ้า
778,2419,2165,4584,1736,ทต.ลาดใหญ่
779,2166,2118,4284,2492,ทต.ลานกระบือ
780,4453,4226,8679,2909,ทต.ลานข่อย
781,907,869,1776,1011,ทต.ลานสกา
782,1728,1689,3417,2126,ทต.ลานสัก
783,1869,1733,3602,1707,ทต.ลานหอย
784,2203,2062,4265,1324,ทต.ลำคลอง
785,2259,2086,4345,1852,ทต.ลำดวนสุรพินท์
786,2219,2086,4305,2370,ทต.ลำทับ
787,2391,2365,4756,1373,ทต.ลำนางแก้ว
788,8236,7647,15883,8564,ทต.ลำนารายณ์
789,6938,6420,13358,6141,ทต.ลำปลายมาศ
790,4833,4412,9245,3321,ทต.ลำปางหลวง
791,1000,921,1921,624,ทต.ลำพญา
792,2758,2821,5579,1984,ทต.ลำพันชาด
793,1465,1980,3445,1489,ทต.ลำภูรา
794,10030,9079,19109,10044,ทต.ลำลูกกา
795,496,495,991,378,ทต.ลำใหม่
796,1328,1288,2616,1043,ทต.ลำไทร
797,8011,7859,15870,4572,ทต.ลำไพล
798,1924,1669,3593,1510,ทต.ลูกแก
799,1611,1544,3155,1545,ทต.วงฆ้อง
800,1520,1494,3014,1045,ทต.วังกรด
801,4535,4683,9218,2553,ทต.วังกะ
802,5148,4530,9678,3397,ทต.วังกะพี้
803,4768,4354,9122,3843,ทต.วังขนาย
804,1886,1669,3555,1317,ทต.วังชมภู
805,3327,3109,6436,2871,ทต.วังชัย
806,1507,1435,2942,1417,ทต.วังชิ้น
807,2250,2093,4343,2701,ทต.วังดิน
808,809,820,1629,648,ทต.วังตะกู
809,3415,3273,6688,2458,ทต.วังตะเคียน
810,1683,1617,3300,1224,ทต.วังทรายพูน
811,2305,2040,4345,1713,ทต.วังทอง
812,4062,3626,7688,3237,ทต.วังผาง
813,2197,2091,4288,2550,ทต.วังม่วง
814,2784,2705,5489,2112,ทต.วังยาง
815,3636,3284,6920,2724,ทต.วังยาง
816,1534,1486,3020,1320,ทต.วังวิเศษ
817,6090,5758,11848,5126,ทต.วังศาลา
818,5434,5286,10720,5020,ทต.วังสมบูรณ์
819,3072,2933,6005,2798,ทต.วังสามหมอ
820,2133,2105,4238,1933,ทต.วังเจ้า
821,4678,4551,9229,3234,ทต.วังเย็น
822,2013,2035,4048,1958,ทต.วังเหนือ
823,2025,1842,3867,1494,ทต.วังโป่ง
824,1007,1070,2077,883,ทต.วังโพธิ์
825,5804,5627,11431,4986,ทต.วังไทร
826,3525,3195,6720,4604,ทต.วังไผ่
827,3104,2700,5804,3038,ทต.วัฒนานคร
828,9765,8848,18613,10822,ทต.วัดประดู่
829,1698,1516,3214,1968,ทต.วัดสิงห์
830,716,666,1382,562,ทต.วัดเพลง
831,4229,3802,8031,3958,ทต.วัดโบสถ์
832,3091,2773,5864,2370,ทต.วานรนิวาส
833,2492,2268,4760,2352,ทต.วาปีปทุม
834,1462,1396,2858,1335,ทต.วาริชภูมิ
835,27812,24471,52283,34698,ทต.วิชิต
836,2200,1964,4164,1892,ทต.วิหารแดง
837,3233,2749,5982,2988,ทต.วิเศษไชยชาญ
838,5633,5108,10741,3388,ทต.ศรีดอนไผ่
839,2750,2683,5433,1880,ทต.ศรีธาตุ
840,1648,1440,3088,1677,ทต.ศรีนคร
841,3052,2689,5741,2596,ทต.ศรีประจันต์
842,1625,1376,3001,1195,ทต.ศรีพนมมาศ
843,3330,3305,6635,2664,ทต.ศรีพนา
844,1873,1766,3639,2408,ทต.ศรีมหาโพธิ
845,2387,2327,4714,1454,ทต.ศรีรัตนะ
846,5551,5539,11090,3835,ทต.ศรีวิไล
847,2588,2473,5061,2477,ทต.ศรีสงคราม
848,2500,2581,5081,1770,ทต.ศรีสาคร
849,3902,3385,7287,3463,ทต.ศรีสำโรง
850,3267,3158,6425,2793,ทต.ศรีเชียงใหม่
851,2851,2648,5499,2221,ทต.ศรีเตี้ย
852,2103,2097,4200,1908,ทต.ศรีเมืองใหม่
853,10781,9276,20057,10742,ทต.ศาลากลาง
854,5284,5970,11254,7650,ทต.ศาลายา
855,1325,1286,2611,1186,ทต.ศาลาลำดวน
856,760,709,1469,522,ทต.ศาลาแดง
857,1023,910,1933,950,ทต.ศาลเจ้าพ่อ
858,1700,1668,3368,1273,ทต.ศาลเจ้าพ่อขุนศรี
859,1756,1562,3318,1444,ทต.ศาลเจ้าไก่ต่อ
860,2454,2241,4695,2782,ทต.ศีขรภูมิ
861,5698,5319,11017,5570,ทต.สตึก
862,1467,1315,2782,1290,ทต.สทิงพระ
863,2576,2453,5029,1589,ทต.สนม
864,2287,2022,4309,2900,ทต.สนามชัยเขต
865,4112,3818,7930,3376,ทต.สบบง
866,2895,2621,5516,2069,ทต.สบปราบ
867,3523,3339,6862,3306,ทต.สมเด็จ
868,1619,1498,3117,1355,ทต.สรรพยา
869,1203,1202,2405,970,ทต.สระกระโจม
870,938,901,1839,631,ทต.สระบัว
871,1388,1410,2798,995,ทต.สระพังทอง
872,1499,1349,2848,1043,ทต.สระยายโสม
873,3795,3479,7274,3251,ทต.สระโบสถ์
874,1960,1992,3952,1074,ทต.สร้างก่อ
875,3756,3633,7389,2597,ทต.สร้างคอม
876,4291,3905,8196,4406,ทต.สลกบาตร
877,4023,3616,7639,3979,ทต.สวนดอกไม้
878,1716,1723,3439,1846,ทต.สวนผึ้ง
879,17598,17673,35271,21467,ทต.สวนหลวง
880,3417,3195,6612,2285,ทต.สวนแตง
881,3412,3173,6585,2893,ทต.สว่างวัฒนา
882,841,799,1640,966,ทต.สว่างอารมณ์
883,4325,3966,8291,4561,ทต.สว่างแดนดิน
884,3648,3073,6721,3101,ทต.สอง
885,681,625,1306,786,ทต.สะบ้าย้อย
886,1161,1053,2214,1131,ทต.สะพลี
887,5014,4983,9997,2670,ทต.สะอาด
888,2683,2689,5372,2531,ทต.สะเมิงใต้
889,2065,1785,3850,2274,ทต.สังขะ
890,1690,1622,3312,1421,ทต.สังคม
891,9463,8187,17650,8989,ทต.สันกำแพง
892,1367,1240,2607,1234,ทต.สันทราย
893,15455,12882,28337,15144,ทต.สันทรายหลวง
894,6921,5853,12774,8138,ทต.สันนาเม็ง
895,8904,7689,16593,9034,ทต.สันปูเลย
896,2412,2049,4461,2745,ทต.สันป่าตอง
897,3323,2816,6139,3322,ทต.สันพระเนตร
898,4421,3962,8383,4984,ทต.สันมหาพน
899,2760,2492,5252,2364,ทต.สากเหล็ก
900,3683,3341,7024,2904,ทต.สามกอ
901,2551,2242,4793,2257,ทต.สามง่าม
902,7239,6674,13913,4830,ทต.สามง่าม
903,699,649,1348,471,ทต.สามง่ามท่าโบสถ์
904,6809,6079,12888,6747,ทต.สามชุก
905,4542,4468,9010,2369,ทต.สามัคคีพัฒนา
906,2419,2182,4601,2085,ทต.สามเงา
907,3742,3640,7382,2819,ทต.สามเมือง
908,1987,1903,3890,2204,ทต.สามแยก
909,5606,5080,10686,3504,ทต.สามโก้
910,3775,3367,7142,2667,ทต.สารภี
911,9217,8950,18167,5624,ทต.สาวะถี
912,7415,6331,13746,9249,ทต.สำนักขาม
913,1116,1099,2215,886,ทต.สำนักขุนเณร
914,5711,5540,11251,5898,ทต.สำนักท้อน
915,942,901,1843,629,ทต.สำรอง
916,1197,1159,2356,1248,ทต.สำโรงทาบ
917,16611,14022,30633,29943,ทต.สำโรงเหนือ
918,6333,6343,12676,3711,ทต.สำโรงใหม่
919,3590,3368,6958,3978,ทต.สิชล
920,2236,2351,4587,1580,ทต.สิริราช
921,740,687,1427,661,ทต.สิเกา
922,1725,1668,3393,1539,ทต.สีชมพู
923,1838,1791,3629,1425,ทต.สีดา
924,4494,4471,8965,4221,ทต.สีมามงคล
925,1688,1783,3471,1569,ทต.สุคิริน
926,7838,7148,14986,9995,ทต.สุนทรภู่
927,3976,3813,7789,2825,ทต.สุวรรณคูหา
928,4782,4289,9071,4199,ทต.สุวรรณภูมิ
929,8631,8477,17108,11293,ทต.สุเทพ
930,5234,4627,9861,6217,ทต.สูงเนิน
931,2039,1751,3790,1896,ทต.สูงเม่น
932,2467,2468,4935,1551,ทต.ส่องดาว
933,3461,3287,6748,2730,ทต.หงส์หิน
934,1284,1205,2489,1093,ทต.หงาว
935,2117,1957,4074,1336,ทต.หนองกราด
936,5081,4753,9834,4111,ทต.หนองกี่
937,4512,4406,8918,3380,ทต.หนองกุงศรี
938,2673,2416,5089,1608,ทต.หนองขาว
939,311,281,592,326,ทต.หนองขาหย่าง
940,1994,1783,3777,2141,ทต.หนองคล้า
941,1452,1284,2736,1001,ทต.หนองจอก
942,3149,3143,6292,1982,ทต.หนองจิก
943,9319,7792,17111,9153,ทต.หนองจ๊อม
944,1472,1303,2775,1888,ทต.หนองฉาง
945,4501,3932,8433,3521,ทต.หนองตองพัฒนา
946,1541,1471,3012,949,ทต.หนองตากยา
947,4852,5114,9966,3981,ทต.หนองตาคง
948,10661,10433,21094,16219,ทต.หนองตำลึง
949,3984,3736,7720,2191,ทต.หนองตูม
950,6629,6638,13267,4973,ทต.หนองน้ำใส
951,3700,3801,7501,3911,ทต.หนองบอน
952,1211,1064,2275,971,ทต.หนองบัว
953,17220,15923,33143,15723,ทต.หนองบัว
954,6082,5555,11637,4981,ทต.หนองบัว
955,3407,3062,6469,2908,ทต.หนองบัว
956,4512,4269,8781,2640,ทต.หนองบัวตะเกียด
957,2980,2931,5911,2599,ทต.หนองบัวระเหว
958,1241,1229,2470,855,ทต.หนองบัวลาย
959,2335,2288,4623,1814,ทต.หนองบัววง
960,4514,4358,8872,4207,ทต.หนองบัวแดง
961,1013,986,1999,782,ทต.หนองบัวโคก
962,2276,2161,4437,1743,ทต.หนองปรือ
963,1734,1676,3410,1142,ทต.หนองปล้อง
964,3948,3375,7323,6035,ทต.หนองป่าครั่ง
965,8380,7200,15580,8718,ทต.หนองผึ้ง
966,5070,4866,9936,3348,ทต.หนองผือ
967,1142,1070,2212,957,ทต.หนองฝ้าย
968,3466,3329,6795,2290,ทต.หนองพยอม
969,2450,2264,4714,2828,ทต.หนองพลับ
970,3335,3169,6504,2623,ทต.หนองพอก
971,2600,2442,5042,2134,ทต.หนองม่วง
972,2402,2071,4473,1880,ทต.หนองม่วงไข่
973,1924,1766,3690,1793,ทต.หนองยวง
974,1100,1031,2131,789,ทต.หนองรี
975,2902,2714,5616,2513,ทต.หนองล่อง
976,4943,4705,9648,2845,ทต.หนองวัวซอ
977,1138,1008,2146,668,ทต.หนองสระ
978,3770,3510,7280,2240,ทต.หนองสอ
979,2671,2648,5319,2051,ทต.หนองสองห้อง
980,2978,2912,5890,2737,ทต.หนองสองห้อง
981,1924,1728,3652,1197,ทต.หนองสาหร่าย
982,2376,2372,4748,1715,ทต.หนองหงส์
983,1320,1219,2539,1085,ทต.หนองหญ้าไซ
984,856,818,1674,494,ทต.หนองหมู
985,4102,4072,8174,2014,ทต.หนองหว้า
986,4267,3544,7811,5443,ทต.หนองหอย
987,2287,2263,4550,1405,ทต.หนองหัวฟาน
988,2228,2020,4248,1868,ทต.หนองหาน
989,2259,2190,4449,2006,ทต.หนองหิน
990,2714,2645,5359,1596,ทต.หนองหิน
991,1615,1345,2960,1495,ทต.หนองเบน
992,4139,4108,8247,2230,ทต.หนองเม็ก
993,2136,2157,4293,2133,ทต.หนองเรือ
994,1571,1465,3036,1870,ทต.หนองเสือ
995,718,717,1435,690,ทต.หนองแก
996,6413,5988,12401,6325,ทต.หนองแค
997,3963,3801,7764,2733,ทต.หนองแซง
998,1484,1366,2850,1014,ทต.หนองแซง
999,3521,3250,6771,2146,ทต.หนองแปน
1000,8322,8485,16807,4175,ทต.หนองแวง
1001,1274,1140,2414,1033,ทต.หนองโดน
1002,2067,1837,3904,2156,ทต.หนองโพ
1003,4167,4342,8509,3367,ทต.หนองใหญ่
1004,3070,3094,6164,1802,ทต.หนองไข่น้ำ
1005,9528,8746,18274,5400,ทต.หนองไผ่
1006,3849,3520,7369,3836,ทต.หนองไผ่
1007,4668,11245,15913,11289,ทต.หนองไผ่ล้อม
1008,1207,1115,2322,1571,ทต.หนองไผ่แก้ว
1009,5035,5064,10099,2880,ทต.หนองไม้งาม
1010,6351,6776,13127,11074,ทต.หนองไม้แดง
1011,3944,3977,7921,3292,ทต.หน้าพระลาน
1012,4164,4142,8306,2902,ทต.หน้าสตน
1013,7049,6594,13643,4432,ทต.หมอนนาง
1014,6676,6599,13275,11414,ทต.หมูสี
1015,2193,1972,4165,2320,ทต.หลวงเหนือ
1016,21555,20329,41884,10326,ทต.หลักห้า
1017,8047,9487,17534,6990,ทต.หลักเมือง
1018,2607,2517,5124,1742,ทต.หลุมดิน
1019,3129,2799,5928,2624,ทต.หล่มเก่า
1020,2224,2070,4294,1836,ทต.หวายเหนียว
1021,3606,3640,7246,2304,ทต.หอคำ
1022,632,650,1282,327,ทต.หอมศีล
1023,3019,2884,5903,2671,ทต.หอไกร
1024,2185,1934,4119,2413,ทต.หันคา
1025,2009,1817,3826,2080,ทต.หัวกุญแจ
1026,4221,4009,8230,2604,ทต.หัวช้าง
1027,2840,2689,5529,2133,ทต.หัวดง
1028,1626,1544,3170,1174,ทต.หัวดง
1029,3465,3318,6783,2166,ทต.หัวตะพาน
1030,14508,13232,27740,13551,ทต.หัวทะเล
1031,6698,6586,13284,3512,ทต.หัวนา
1032,1795,1835,3630,1031,ทต.หัวนา
1033,5585,5774,11359,3153,ทต.หัวนาคำ
1034,6536,6252,12788,3710,ทต.หัวนาคำ
1035,3120,2838,5958,1993,ทต.หัวสะพาน
1036,3426,3275,6701,3884,ทต.หัวสำโรง
1037,3078,2871,5949,1800,ทต.หัวเวียง
1038,2188,2027,4215,1832,ทต.หัวไทร
1039,3925,3344,7269,3813,ทต.หางดง
1040,3170,2952,6122,3069,ทต.หางน้ำสาคร
1041,3868,3661,7529,2626,ทต.หาดกรวด
1042,4754,4601,9355,2931,ทต.หาดคำ
1043,2591,2461,5052,1782,ทต.หาดท่าเสา
1044,2567,2366,4933,2513,ทต.หาดเจ้าสำราญ
1045,2605,2746,5351,1967,ทต.หาดเล็ก
1046,3499,3090,6589,3584,ทต.หาดเสี้ยว
1047,5092,4949,10041,3472,ทต.หารเทา
1048,4981,4426,9407,5566,ทต.หินกอง
1049,1389,1410,2799,765,ทต.หินดาด
1050,4172,4171,8343,2724,ทต.หินตก
1051,2550,2506,5056,1803,ทต.หินเหล็กไฟ
1052,874,822,1696,729,ทต.ห้วยกระบอก
1053,8699,7696,16395,10120,ทต.ห้วยกะปิ
1054,1634,1551,3185,973,ทต.ห้วยขะยุง
1055,4281,3960,8241,4133,ทต.ห้วยข้าวก่ำ
1056,5890,5454,11344,4284,ทต.ห้วยชินสีห์
1057,6204,6212,12416,5237,ทต.ห้วยซ้อ
1058,1630,1698,3328,1053,ทต.ห้วยทับทัน
1059,2942,2827,5769,2243,ทต.ห้วยผึ้ง
1060,1155,1030,2185,890,ทต.ห้วยพลู
1061,4320,3932,8252,4110,ทต.ห้วยยอด
1062,7702,7760,15462,4582,ทต.ห้วยยาง
1063,2579,2515,5094,1382,ทต.ห้วยราช
1064,4645,4270,8915,3275,ทต.ห้วยลาน
1065,4890,4852,9742,2569,ทต.ห้วยหิน
1066,2586,2274,4860,2218,ทต.ห้วยอ้อ
1067,2700,2608,5308,1684,ทต.ห้วยเกิ้ง
1068,2912,2789,5701,2171,ทต.ห้วยเม็ก
1069,1664,1513,3177,1605,ทต.ห้วยแถลง
1070,5946,5857,11803,3378,ทต.ห้วยโพธิ์
1071,16181,14472,30653,17569,ทต.ห้วยใหญ่
1072,2705,2331,5036,2501,ทต.ห้วยไคร้
1073,1532,1251,2783,1288,ทต.ห้างฉัตร
1074,1366,1272,2638,1296,ทต.องครักษ์
1075,526,552,1078,825,ทต.อมก๋อย
1076,4040,3745,7785,2810,ทต.อรัญญิก
1077,4075,4100,8175,2105,ทต.อัคคะคำ
1078,2471,2260,4731,1961,ทต.อัมพวา
1079,4605,4379,8984,3026,ทต.อากาศอำนวย
1080,2059,1960,4019,1769,ทต.อาจสามารถ
1081,1138,989,2127,959,ทต.อำนาจ
1082,4430,4331,8761,2495,ทต.อิตื้อ
1083,2388,2169,4557,2278,ทต.อินทร์บุรี
1084,11070,10046,21116,12564,ทต.อิสาณ
1085,3523,3097,6620,4077,ทต.อุทัย
1086,3123,2657,5780,3098,ทต.อุบล
1087,6855,6027,12882,5915,ทต.อุโมงค์
1088,3720,3596,7316,2013,ทต.อุ่มเม้า
1089,1794,1912,3706,898,ทต.อุ้มผาง
1090,3996,3575,7571,3662,ทต.อู่ทอง
1091,1618,1491,3109,1006,ทต.อ่างศิลา
1092,2372,2278,4650,1634,ทต.อ่าวพะยูน
1093,2954,2711,5665,2915,ทต.อ่าวลึกใต้
1094,12673,11600,24273,21722,ทต.อ้อมใหญ่
1095,5316,7486,12802,6346,ทต.เกล็ดแก้ว
1096,2437,2093,4530,2149,ทต.เกวียนหัก
1097,2641,2451,5092,1564,ทต.เกษตรพัฒนา
1098,5658,5320,10978,4820,ทต.เกษตรวิสัย
1099,1552,1404,2956,1313,ทต.เกษตรสมบูรณ์
1100,1413,1380,2793,949,ทต.เกษไชโย
1101,1123,1040,2163,1090,ทต.เกาะขนุน
1102,8712,7930,16642,7979,ทต.เกาะขวาง
1103,2432,2114,4546,2337,ทต.เกาะคา
1104,1840,3387,5227,1798,ทต.เกาะจันทร์
1105,3759,3706,7465,5471,ทต.เกาะพะงัน
1106,424,409,833,495,ทต.เกาะยาว
1107,602,570,1172,497,ทต.เกาะลันตาใหญ่
1108,2268,2226,4494,2187,ทต.เกาะสีชัง
1109,956,850,1806,748,ทต.เกาะหวาย
1110,3385,3487,6872,2121,ทต.เกาะเพชร
1111,5924,5558,11482,3773,ทต.เกาะแต้ว
1112,3000,2766,5766,2293,ทต.เก้าเลี้ยว
1113,21854,33130,54984,26594,ทต.เขตรอุดมศักดิ์
1114,3103,2882,5985,2486,ทต.เขมราฐ
1115,3771,3503,7274,2604,ทต.เขาขวาง
1116,4777,4405,9182,2844,ทต.เขางู
1117,2446,2396,4842,2309,ทต.เขาฉกรรจ์
1118,1861,1669,3530,1597,ทต.เขาชัยสน
1119,2237,2104,4341,1355,ทต.เขาชุมทอง
1120,3105,2955,6060,2079,ทต.เขาดิน
1121,2201,2155,4356,1890,ทต.เขาทราย
1122,3312,3254,6566,2759,ทต.เขานิพันธ์
1123,3253,2988,6241,2369,ทต.เขาบางแกรก
1124,3209,3100,6309,2504,ทต.เขาบายศรี
1125,2988,2764,5752,2468,ทต.เขาพนม
1126,3026,2610,5636,3229,ทต.เขาพระ
1127,4091,4097,8188,3337,ทต.เขาพระ
1128,9267,16029,25296,11806,ทต.เขาพระงาม
1129,8049,7290,15339,8081,ทต.เขาย้อย
1130,705,719,1424,614,ทต.เขาสมิง
1131,5441,5384,10825,3633,ทต.เขาสวนกวาง
1132,3585,3561,7146,2142,ทต.เขาหัวช้าง
1133,1793,1729,3522,2587,ทต.เขาหินซ้อน
1134,3862,3927,7789,2148,ทต.เขาแก้ว
1135,2332,2215,4547,2053,ทต.เขื่องใน
1136,2136,2349,4485,2000,ทต.เขื่อนบางลาง
1137,2079,2010,4089,2075,ทต.เขื่อนอุบลรัตน์
1138,838,868,1706,741,ทต.เคียนซา
1139,2436,2384,4820,2102,ทต.เจดีย์หลวง
1140,4227,3839,8066,3862,ทต.เจดีย์แม่ครัว
1141,3499,3360,6859,2249,ทต.เจริญศิลป์
1142,3021,2748,5769,2219,ทต.เจ็ดเสมียน
1143,5548,5200,10748,3165,ทต.เจ้าเจ็ด
1144,2023,2016,4039,997,ทต.เจ๊ะบิลัง
1145,3779,3773,7552,2556,ทต.เฉลียงทอง
1146,4028,3692,7720,3617,ทต.เชิงดอย
1147,3806,3064,6870,3661,ทต.เชิงทะเล
1148,2605,2567,5172,1609,ทต.เชียงกลม
1149,4926,4730,9656,3909,ทต.เชียงกลาง
1150,2681,2486,5167,2751,ทต.เชียงคาน
1151,3389,2823,6212,3667,ทต.เชียงคำ
1152,2105,1869,3974,2300,ทต.เชียงดาว
1153,4355,4324,8679,3845,ทต.เชียงม่วน
1154,2404,2283,4687,2371,ทต.เชียงยืน
1155,5229,4895,10124,4340,ทต.เชียงรากน้อย
1156,8935,8308,17243,5974,ทต.เชียงเครือ
1157,2007,1992,3999,1162,ทต.เชียงเพ็ง
1158,4160,4063,8223,2404,ทต.เชียงใหม่
1159,818,804,1622,748,ทต.เชียรใหญ่
1160,3615,3155,6770,2798,ทต.เดิมบาง
1161,5822,5247,11069,5144,ทต.เด่นชัย
1162,4760,4496,9256,4982,ทต.เทพกระษัตรี
1163,10289,9753,20042,8332,ทต.เทพนคร
1164,2179,2095,4274,1259,ทต.เทพราช
1165,5926,6007,11933,4039,ทต.เทพวงศา
1166,1926,1916,3842,2261,ทต.เทพสถิต
1167,1200,1150,2350,1056,ทต.เทพา
1168,1453,1349,2802,839,ทต.เทพาลัย
1169,6161,5844,12005,4505,ทต.เนินกุ่ม
1170,3133,2851,5984,2622,ทต.เนินขาม
1171,2362,2237,4599,1925,ทต.เนินฆ้อ
1172,4538,4531,9069,3069,ทต.เนินปอ
1173,3531,3273,6804,2981,ทต.เนินมะกอก
1174,1780,1670,3450,1583,ทต.เนินมะปราง
1175,974,904,1878,1248,ทต.เนินสันติ
1176,1585,1444,3029,1646,ทต.เนินสูง
1177,8514,7559,16073,6524,ทต.เบิกไพร
1178,3027,2875,5902,1976,ทต.เปือยน้อย
1179,5478,5464,10942,3989,ทต.เฝ้าไร่
1180,1403,1382,2785,1578,ทต.เพ็ญ
1181,1130,1005,2135,991,ทต.เมืองการุ้ง
1182,2247,2122,4369,2167,ทต.เมืองขุขันธ์
1183,1157,1071,2228,995,ทต.เมืองคง
1184,2038,1946,3984,2101,ทต.เมืองคง
1185,2031,1795,3826,1931,ทต.เมืองงาย
1186,945,960,1905,559,ทต.เมืองที
1187,19024,18324,37348,9198,ทต.เมืองนะ
1188,4325,4133,8458,2766,ทต.เมืองบัว
1189,3473,3024,6497,3500,ทต.เมืองพาน
1190,4095,4036,8131,2287,ทต.เมืองยาง
1191,2580,2519,5099,1865,ทต.เมืองรามันห์
1192,3146,3015,6161,3367,ทต.เมืองศรีไค
1193,4792,4710,9502,2827,ทต.เมืองสรวง
1194,3352,3232,6584,4423,ทต.เมืองเก่า
1195,3829,3339,7168,2581,ทต.เมืองเก่า
1196,16505,14491,30996,17037,ทต.เมืองเก่า
1197,9793,8879,18672,11600,ทต.เมืองแกลง
1198,3087,3163,6250,1578,ทต.เมืองไพร
1199,2386,2117,4503,1691,ทต.เรณูนคร
1200,1318,1311,2629,1300,ทต.เลาขวัญ
1201,1529,1435,2964,1083,ทต.เลิงนกทา
1202,2835,2649,5484,2259,ทต.เวียง
1203,4837,4709,9546,4198,ทต.เวียง
1204,5283,5207,10490,3190,ทต.เวียงคำ
1205,3111,2867,5978,1888,ทต.เวียงคุก
1206,3614,3176,6790,3077,ทต.เวียงชัย
1207,3151,3208,6359,2435,ทต.เวียงต้า
1208,2466,2081,4547,2386,ทต.เวียงป่าเป้า
1209,4481,4098,8579,3937,ทต.เวียงฝาง
1210,2587,2234,4821,2810,ทต.เวียงพร้าว
1211,11934,10359,22293,9670,ทต.เวียงพางคำ
1212,5163,5114,10277,3493,ทต.เวียงมอก
1213,3616,3140,6756,3329,ทต.เวียงยอง
1214,3196,2987,6183,2656,ทต.เวียงลอ
1215,4960,4481,9441,5762,ทต.เวียงสระ
1216,1545,1317,2862,1295,ทต.เวียงสา
1217,2027,1792,3819,2342,ทต.เวียงเชียงของ
1218,3452,3045,6497,3326,ทต.เวียงเชียงแสน
1219,2708,2337,5045,2744,ทต.เวียงเทิง
1220,2967,2796,5763,1950,ทต.เสนางคนิคม
1221,12377,10174,22551,17440,ทต.เสม็ด
1222,4198,4133,8331,2996,ทต.เสริมงาม
1223,6734,6315,13049,4975,ทต.เสลภูมิ
1224,21586,17988,39574,26509,ทต.เสาธงหิน
1225,1622,1500,3122,1441,ทต.เสาไห้
1226,3961,3688,7649,3158,ทต.เสิงสาง
1227,3873,3646,7519,2430,ทต.เสือโฮก
1228,2227,2065,4292,2412,ทต.เหนือคลอง
1229,8631,7235,15866,8194,ทต.เหมืองง่า
1230,1019,955,1974,773,ทต.เหมืองใหม่
1231,488,472,960,723,ทต.เอราวัณ
1232,2670,2674,5344,1575,ทต.แกดำ
1233,3683,3417,7100,3279,ทต.แกลงกะเฉด
1234,3384,2951,6335,3758,ทต.แก่งเสี้ยน
1235,1346,1289,2635,1050,ทต.แก่งเสือเต้น
1236,4538,4088,8626,4508,ทต.แก้งคร้อ
1237,2764,2753,5517,1885,ทต.แคนดง
1238,2794,2626,5420,3037,ทต.แคมป์สน
1239,1835,1673,3508,1670,ทต.แจ้ห่ม
1240,3247,2845,6092,3006,ทต.แชะ
1241,3140,2985,6125,3465,ทต.แปลงยาว
1242,1346,1162,2508,1353,ทต.แพรกศรีราชา
1243,14243,12597,26840,15544,ทต.แพรกษา
1244,6871,6249,13120,6743,ทต.แม่กา
1245,3302,3202,6504,2861,ทต.แม่กุ
1246,3244,2995,6239,3398,ทต.แม่ขรี
1247,1557,1369,2926,1579,ทต.แม่ขะจาน
1248,2417,2161,4578,2153,ทต.แม่คำ
1249,3681,3531,7212,2706,ทต.แม่คำมี
1250,2721,2590,5311,2153,ทต.แม่จะเรา
1251,1954,1704,3658,2420,ทต.แม่จัน
1252,1968,1821,3789,1556,ทต.แม่จั๊วะ
1253,1803,1655,3458,1349,ทต.แม่ตืน
1254,1936,1896,3832,1377,ทต.แม่ต้าน
1255,3332,3255,6587,2955,ทต.แม่ทะ
1256,3090,3046,6136,2605,ทต.แม่ปั๋ง
1257,1445,1482,2927,1140,ทต.แม่ปาน
1258,4619,4435,9054,3400,ทต.แม่ปืม
1259,2025,1844,3869,1333,ทต.แม่ปุ
1260,1349,1256,2605,1111,ทต.แม่พริก
1261,10927,10700,21627,8977,ทต.แม่ยาว
1262,2000,1991,3991,1846,ทต.แม่ระมาด
1263,5032,4416,9448,5752,ทต.แม่ริม
1264,3347,3195,6542,2615,ทต.แม่ลานนา
1265,1818,1797,3615,1778,ทต.แม่ลาน้อย
1266,958,858,1816,803,ทต.แม่ลาว
1267,2427,2152,4579,2186,ทต.แม่วาง
1268,764,718,1482,1093,ทต.แม่สรวย
1269,1505,1346,2851,1945,ทต.แม่สะเรียง
1270,15125,13196,28321,13624,ทต.แม่สาย
1271,2371,2047,4418,1965,ทต.แม่หล่าย
1272,5481,5153,10634,4853,ทต.แม่อาย
1273,7837,7562,15399,8627,ทต.แม่เมาะ
1274,1331,1296,2627,1606,ทต.แม่แจ่ม
1275,4806,4255,9061,3889,ทต.แม่แฝก
1276,3681,3405,7086,2886,ทต.แม่แรง
1277,2618,2388,5006,2152,ทต.แม่ใจ
1278,2891,2709,5600,2178,ทต.แวงน่าง
1279,1604,1468,3072,1303,ทต.แวงน้อย
1280,2661,2481,5142,1744,ทต.แวงใหญ่
1281,2741,2611,5352,1665,ทต.แว้ง
1282,2003,2013,4016,968,ทต.แสงสว่าง
1283,1640,1605,3245,2354,ทต.แสนตุ้ง
1284,11111,13626,24737,10917,ทต.แสนสุข
1285,1655,1595,3250,1258,ทต.แสวงหา
1286,925,886,1811,718,ทต.แหลมงอบ
1287,10960,10349,21309,9008,ทต.แหลมฟ้าผ่า
1288,2046,2069,4115,1233,ทต.แหลมสัก
1289,2978,2899,5877,1539,ทต.โกตาบารู
1290,1191,1094,2285,997,ทต.โกรกพระ
1291,4817,4409,9226,4204,ทต.โกสุมพิสัย
1292,3792,3350,7142,4376,ทต.โคกกรวด
1293,1838,1697,3535,1710,ทต.โคกกลอย
1294,813,724,1537,862,ทต.โคกคราม
1295,14975,14596,29571,11496,ทต.โคกตูม
1296,3088,2804,5892,2308,ทต.โคกปีบ
1297,1788,1628,3416,1459,ทต.โคกพระ
1298,1145,1040,2185,813,ทต.โคกมะกอก
1299,3494,4219,7713,2734,ทต.โคกม่วง
1300,5272,5114,10386,3623,ทต.โคกม่วง
1301,3728,3675,7403,2063,ทต.โคกล่าม
1302,1622,1553,3175,1261,ทต.โคกศรี
1303,2715,2582,5297,1773,ทต.โคกสวาย
1304,3294,3257,6551,2165,ทต.โคกสะอาด
1305,3047,2798,5845,2434,ทต.โคกสำโรง
1306,4338,4536,8874,2418,ทต.โคกสูง
1307,2306,2071,4377,1301,ทต.โคกสูงสัมพันธ์
1308,1763,1593,3356,1790,ทต.โคกโพธิ์
1309,6659,6037,12696,5507,ทต.โชคชัย
1310,3311,3304,6615,2558,ทต.โซ่พิสัย
1311,4856,4689,9545,3576,ทต.โนนดินแดง
1312,2603,2624,5227,1423,ทต.โนนตาล
1313,4977,4842,9819,3104,ทต.โนนท่อน
1314,2725,2498,5223,1976,ทต.โนนบุรี
1315,5542,5583,11125,3460,ทต.โนนปอแดง
1316,2775,2825,5600,1781,ทต.โนนศิลา
1317,2938,2911,5849,1810,ทต.โนนสมบูรณ์
1318,2976,2949,5925,1759,ทต.โนนสมบูรณ์
1319,3492,3414,6906,2342,ทต.โนนสว่าง
1320,2284,2205,4489,1738,ทต.โนนสะอาด
1321,4277,4145,8422,2768,ทต.โนนสัง
1322,1691,1628,3319,1065,ทต.โนนสุวรรณ
1323,5016,4633,9649,3967,ทต.โนนสูง
1324,2473,2274,4747,2603,ทต.โนนสูงเปลือย
1325,2457,2224,4681,1525,ทต.โนนหัน
1326,2214,2104,4318,1561,ทต.โนนแดง
1327,1664,1455,3119,1374,ทต.โนนไทย
1328,5488,5044,10532,6330,ทต.โป่ง
1329,4203,4908,9111,4209,ทต.โป่งน้ำร้อน
1330,1282,1212,2494,1015,ทต.โพทะเล
1331,4575,4623,9198,2048,ทต.โพธิ์กระสังข์
1332,13917,15391,29308,13214,ทต.โพธิ์กลาง
1333,3982,3718,7700,3710,ทต.โพธิ์ชัย
1334,3386,3356,6742,1723,ทต.โพธิ์ชัย
1335,2261,2012,4273,1829,ทต.โพธิ์ทอง
1336,4992,4649,9641,3575,ทต.โพธิ์ประทับช้าง
1337,1865,1522,3387,1710,ทต.โพธิ์พระยา
1338,828,757,1585,571,ทต.โพธิ์พิทักษ์
1339,1551,1507,3058,1169,ทต.โพธิ์ไทร
1340,1926,1887,3813,1091,ทต.โพน
1341,4582,4495,9077,3155,ทต.โพนงาม
1342,2804,2782,5586,1939,ทต.โพนทราย
1343,5800,5604,11404,4935,ทต.โพนทอง
1344,1324,1326,2650,1229,ทต.โพนพิสัย
1345,2681,2688,5369,1820,ทต.โพนสวรรค์
1346,2000,1769,3769,1135,ทต.โพนสา
1347,3654,3748,7402,1855,ทต.โพนสูง
1348,5656,5164,10820,4178,ทต.โพรงมะเดื่อ
1349,1080,966,2046,837,ทต.โพสังโฆ
1350,5413,5100,10513,3677,ทต.โพหัก
1351,3304,3016,6320,2466,ทต.โรงช้าง
1352,997,853,1850,1010,ทต.ในเมือง
1353,4196,3952,8148,3350,ทต.ในเมือง
1354,6421,6325,12746,3472,ทต.ใหม่
1355,8284,7545,15829,6594,ทต.ไชยปราการ
1356,4248,4049,8297,2351,ทต.ไชยวาน
1357,6577,6123,12700,4156,ทต.ไชโย
1358,2601,2393,4994,2458,ทต.ไทรงาม
1359,1238,1273,2511,1055,ทต.ไทรน้อย
1360,4315,4227,8542,3110,ทต.ไทรย้อย
1361,1854,1801,3655,1147,ทต.ไทรโยง-ไชยวาล
1362,882,841,1723,616,ทต.ไผ่กองดิน
1363,2042,1980,4022,2099,ทต.ไผ่ต่ำ
1364,5436,5454,10890,2883,ทต.ไพรบึง
1365,5443,4889,10332,4946,ทต.ไพศาลี
1366,5232,6530,11762,6340,ทต.ไม้งาม
1367,5313,5317,10630,3749,ทต.ไม้ยา
1368,1244,1151,2395,1252,ทต.ไม้เรียง
1369,5390,5274,10664,4140,ทต.ไร่เก่า
1370,4003,3730,7733,2856,ทต.ไร่ใหม่
1371,58459,52156,110615,66498,ทน.ขอนแก่น
1372,30710,26183,56893,25371,ทน.ตรัง
1373,38308,34445,72753,37774,ทน.นครปฐม
1374,65525,57205,122730,72081,ทน.นครราชสีมา
1375,53005,47411,100416,46553,ทน.นครศรีธรรมราช
1376,42697,38542,81239,42683,ทน.นครสวรรค์
1377,133308,117718,251026,157944,ทน.นนทบุรี
1378,101856,87602,189458,131416,ทน.ปากเกร็ด
1379,25785,23423,49208,20332,ทน.พระนครศรีอยุธยา
1380,34969,29099,64068,36826,ทน.พิษณุโลก
1381,41951,35827,77778,26666,ทน.ภูเก็ต
1382,31606,28377,59983,28297,ทน.ยะลา
1383,33128,29256,62384,37658,ทน.ระยอง
1384,45163,39105,84268,56127,ทน.รังสิต
1385,28003,22964,50967,29304,ทน.ลำปาง
1386,26279,25052,51331,28316,ทน.สกลนคร
1387,31115,28906,60021,27527,ทน.สงขลา
1388,25510,24094,49604,20657,ทน.สมุทรปราการ
1389,33169,32240,65409,18925,ทน.สมุทรสาคร
1390,68995,62604,131599,75558,ทน.สุราษฎร์ธานี
1391,80423,69036,149459,68333,ทน.หาดใหญ่
1392,62804,57398,120202,61123,ทน.อุดรธานี
1393,39050,33805,72855,32040,ทน.อุบลราชธานี
1394,28197,25625,53822,49114,ทน.อ้อมน้อย
1395,35729,33265,68994,55845,ทน.เกาะสมุย
1396,75160,71314,146474,101394,ทน.เจ้าพระยาสุรศักดิ์
1397,40611,36934,77545,50608,ทน.เชียงราย
1398,65314,57313,122627,90147,ทน.เชียงใหม่
1399,20911,20670,41581,19482,ทน.แม่สอด
1400,45483,43974,89457,80380,ทน.แหลมฉบัง
1401,15124,13097,28221,18347,ทม.กระทุ่มล้ม
1402,14112,13444,27556,6403,ทม.กระทุ่มแบน
1403,5223,4823,10046,4505,ทม.กระนวน
1404,17429,15107,32536,17608,ทม.กระบี่
1405,16208,14055,30263,21292,ทม.กะทู้
1406,6009,5806,11815,5033,ทม.กันตัง
1407,9193,8590,17783,7510,ทม.กันทรลักษ์
1408,14231,12706,26937,15913,ทม.กาญจนบุรี
1409,16962,15520,32482,15878,ทม.กาฬสินธุ์
1410,15083,13295,28378,16231,ทม.กำแพงเพชร
1411,5808,5525,11333,4893,ทม.กุฉินารายณ์
1412,5697,5038,10735,4271,ทม.ขลุง
1413,34133,30516,64649,51658,ทม.คลองหลวง
1414,21540,19126,40666,20846,ทม.คลองแห
1415,26209,23112,49321,25502,ทม.ควนลัง
1416,24047,22137,46184,29265,ทม.คอหงส์
1417,22708,21233,43941,26172,ทม.คูคต
1418,6486,5784,12270,7783,ทม.จันทนิมิต
1419,11596,10524,22120,14576,ทม.จันทบุรี
1420,20132,18052,38184,22048,ทม.ฉะเชิงเทรา
1421,13409,12025,25434,12563,ทม.ชลบุรี
1422,20740,19263,40003,45786,ทม.ชะอำ
1423,6301,5374,11675,7441,ทม.ชัยนาท
1424,18850,17051,35901,20764,ทม.ชัยภูมิ
1425,18056,15682,33738,19905,ทม.ชุมพร
1426,16046,14946,30992,15429,ทม.ชุมแพ
1427,4026,3537,7563,3611,ทม.ชุมแสง
1428,6792,5864,12656,5348,ทม.ดอกคำใต้
1429,6215,5883,12098,5734,ทม.ดอนสัก
1430,5057,4689,9746,5523,ทม.ตราด
1431,4267,3962,8229,2708,ทม.ตะกั่วป่า
1432,7224,6312,13536,6249,ทม.ตะพานหิน
1433,7351,7133,14484,4420,ทม.ตะลุบัน
1434,8472,7607,16079,7439,ทม.ตาก
1435,10129,9557,19686,5659,ทม.ตากใบ
1436,12080,11112,23192,9902,ทม.ตาคลี
1437,10473,8790,19263,12944,ทม.ต้นเปา
1438,9866,9848,19714,9568,ทม.ทับกวาง
1439,8679,8262,16941,6032,ทม.ทุ่งตำเสา
1440,16235,13767,30002,11362,ทม.ทุ่งสง
1441,9676,9229,18905,9018,ทม.ท่าข้าม
1442,7507,6344,13851,10442,ทม.ท่าช้าง
1443,8922,8468,17390,7235,ทม.ท่าบ่อ
1444,10392,9764,20156,8155,ทม.ท่าผา
1445,5886,5291,11177,5031,ทม.ท่าเรือพระแท่น
1446,42166,35077,77243,56320,ทม.ท่าโขลง
1447,5406,4724,10130,4549,ทม.ท่าใหม่
1448,8383,7612,15995,8479,ทม.นครนายก
1449,13803,12290,26093,14957,ทม.นครพนม
1450,20460,19673,40133,15736,ทม.นราธิวาส
1451,10966,9768,20734,11298,ทม.นางรอง
1452,9840,9359,19199,8080,ทม.นาสาร
1453,9829,9677,19506,10772,ทม.น่าน
1454,7031,6474,13505,7067,ทม.บัวใหญ่
1455,24054,20473,44527,22035,ทม.บางกรวย
1456,7556,6801,14357,7072,ทม.บางกะดี
1457,27778,23663,51441,25771,ทม.บางบัวทอง
1458,4317,3930,8247,3680,ทม.บางมูลนาก
1459,7391,6546,13937,5624,ทม.บางระจัน
1460,17726,15279,33005,13190,ทม.บางศรีเมือง
1461,10118,9944,20062,11011,ทม.บึงกาฬ
1462,17909,15079,32988,15387,ทม.บึงยี่โถ
1463,13165,11922,25087,14464,ทม.บุรีรัมย์
1464,15939,15243,31182,20588,ทม.บ้านฉาง
1465,8016,7435,15451,6278,ทม.บ้านดุง
1466,9623,8981,18604,8064,ทม.บ้านทุ่ม
1467,11037,9854,20891,10372,ทม.บ้านบึง
1468,13690,12441,26131,12353,ทม.บ้านพรุ
1469,34693,34097,68790,45512,ทม.บ้านสวน
1470,1696,1534,3230,1441,ทม.บ้านหมี่
1471,8650,7545,16195,8256,ทม.บ้านโป่ง
1472,14273,13224,27497,12697,ทม.บ้านไผ่
1473,12448,11080,23528,9506,ทม.ปทุมธานี
1474,9761,8413,18174,10866,ทม.ประจวบคีรีขันธ์
1475,8911,7740,16651,8879,ทม.ปราจีนบุรี
1476,23690,22338,46028,16163,ทม.ปัตตานี
1477,17813,15887,33700,18716,ทม.ปากช่อง
1478,19367,17058,36425,15418,ทม.ปากน้ำสมุทรปราการ
1479,9836,9601,19437,7928,ทม.ปากพนัง
1480,14306,12744,27050,15403,ทม.ปากแพรก
1481,8820,8851,17671,6763,ทม.ปางมะค่า
1482,8177,7761,15938,6168,ทม.ปาดังเบซาร์
1483,36903,34740,71643,35651,ทม.ปู่เจ้าสมิงพราย
1484,10339,9783,20122,16472,ทม.ป่าตอง
1485,4957,4616,9573,4375,ทม.ผักไห่
1486,5455,4620,10075,4989,ทม.พนัสนิคม
1487,4699,4372,9071,2182,ทม.พระประแดง
1488,17745,15713,33458,13230,ทม.พระพุทธบาท
1489,8752,7580,16332,8213,ทม.พะเยา
1490,5292,5037,10329,5897,ทม.พังงา
1491,17513,14910,32423,16063,ทม.พัทลุง
1492,11248,9934,21182,12478,ทม.พิจิตร
1493,6996,6165,13161,6405,ทม.พิชัย
1494,5434,5066,10500,4517,ทม.พิบูลมังสาหาร
1495,25747,22127,47874,23331,ทม.พิมลราช
1496,28176,21604,49780,21442,ทม.มหาสารคาม
1497,35848,36084,71932,59696,ทม.มาบตาพุด
1498,17069,16042,33111,15869,ทม.มุกดาหาร
1499,10434,9798,20232,9098,ทม.ยโสธร
1500,9801,9484,19285,8186,ทม.ระนอง
1501,18765,15948,34713,16379,ทม.ราชบุรี
1502,18957,16846,35803,16762,ทม.ร้อยเอ็ด
1503,11196,10583,21779,12683,ทม.ลพบุรี
1504,36937,33959,70896,37404,ทม.ลัดหลวง
1505,35774,31482,67256,39485,ทม.ลาดสวาย
1506,10956,10401,21357,9689,ทม.ลำตาเสา
1507,6372,5356,11728,7171,ทม.ลำพูน
1508,35491,30685,66176,33373,ทม.ลำสามแก้ว
1509,7650,6637,14287,7054,ทม.ล้อมแรด
1510,10662,10084,20746,9717,ทม.วังน้ำเย็น
1511,5731,5296,11027,4510,ทม.วังสะพุง
1512,13832,12334,26166,10885,ทม.วารินชำราบ
1513,11741,10638,22379,8669,ทม.วิเชียรบุรี
1514,12910,10524,23434,8520,ทม.ศรีราชา
1515,21711,19321,41032,20750,ทม.ศรีสะเกษ
1516,7913,7184,15097,5772,ทม.ศรีสัชนาลัย
1517,11998,11146,23144,10023,ทม.สตูล
1518,16826,15029,31855,17377,ทม.สนั่นรักษ์
1519,14359,12964,27323,10947,ทม.สมุทรสงคราม
1520,29782,29481,59263,28569,ทม.สระบุรี
1521,9522,8841,18363,11424,ทม.สระแก้ว
1522,8142,7323,15465,6724,ทม.สวรรคโลก
1523,6536,5810,12346,5138,ทม.สองพี่น้อง
1524,11090,10526,21616,8747,ทม.สะเดา
1525,17507,16407,33914,14734,ทม.สะเตงนอก
1526,11626,10634,22260,12080,ทม.สัตหีบ
1527,8286,8752,17038,8739,ทม.สามพราน
1528,20162,19706,39868,13077,ทม.สิงหนคร
1529,9125,7954,17079,9201,ทม.สิงห์บุรี
1530,8818,7868,16686,9365,ทม.สีคิ้ว
1531,13479,11411,24890,12975,ทม.สุพรรณบุรี
1532,20895,17722,38617,17172,ทม.สุรินทร์
1533,7493,6552,14045,7072,ทม.สุโขทัยธานี
1534,21510,19312,40822,15395,ทม.สุไหงโกลก
1535,24041,23070,47111,24351,ทม.หนองคาย
1536,11351,10499,21850,11941,ทม.หนองบัวลำภู
1537,48011,39043,87054,50694,ทม.หนองปรือ
1538,14822,14005,28827,14844,ทม.หนองสำโรง
1539,5828,5158,10986,6853,ทม.หลังสวน
1540,6053,5472,11525,6538,ทม.หล่มสัก
1541,33270,31763,65033,57007,ทม.หัวหิน
1542,7913,9051,16964,11256,ทม.อรัญญประเทศ
1543,13556,16858,30414,14023,ทม.อรัญญิก
1544,12970,11992,24962,12695,ทม.อำนาจเจริญ
1545,16864,14354,31218,14654,ทม.อุตรดิตถ์
1546,7684,6563,14247,9614,ทม.อุทัยธานี
1547,10765,9336,20101,10266,ทม.อโยธยา
1548,6409,5817,12226,6597,ทม.อ่างทอง
1549,19462,16903,36365,21585,ทม.อ่างศิลา
1550,31207,28171,59378,25687,ทม.เขลางค์นคร
1551,22913,20195,43108,20451,ทม.เขารูปช้าง
1552,13301,16305,29606,12324,ทม.เขาสามยอด
1553,6959,6435,13394,6578,ทม.เดชอุดม
1554,13691,12730,26421,11310,ทม.เบตง
1555,11007,9969,20976,10308,ทม.เพชรบุรี
1556,11107,9714,20821,12662,ทม.เพชรบูรณ์
1557,7254,6386,13640,6932,ทม.เมืองปัก
1558,5557,5047,10604,5403,ทม.เมืองพล
1559,6632,6247,12879,5691,ทม.เมืองแกนพัฒนา
1560,10448,10350,20798,11715,ทม.เลย
1561,1957,1757,3714,1449,ทม.เสนา
1562,5815,5438,11253,6152,ทม.แก่งคอย
1563,8011,6870,14881,8754,ทม.แพร่
1564,3720,3611,7331,4646,ทม.แม่ฮ่องสอน
1565,10721,8934,19655,13842,ทม.แม่เหียะ
1566,12576,10691,23267,13995,ทม.แม่โจ้
1567,24546,21585,46131,37588,ทม.แสนสุข
1568,3976,4604,8580,3542,ทม.โนนสูง-น้ำคำ
1569,4579,4167,8746,3691,ทม.โพธาราม
1570,12792,10950,23742,15710,ทม.ไทรม้า
1571,17806,15743,33549,24326,ทม.ไร่ขิง
1572,3892,3904,7796,2865,ท้องถิ่นทต.นิคมสร้างตนเองลำโดมน้อย
1573,63896,53710,117606,170621,ท้องถิ่นเมืองพัทยา
1574,14622,14688,29310,9369,อภ.กงหรา
1575,30465,29028,59493,20400,อภ.กงไกรลาศ
1576,68945,66784,135729,52464,อภ.กบินทร์บุรี
1577,23312,22467,45779,12378,อภ.กมลาไสย
1578,14780,14999,29779,6530,อภ.กรงปินัง
1579,33857,31417,65274,38279,อภ.กระทุ่มแบน
1580,34286,33935,68221,20068,อภ.กระนวน
1581,21966,22746,44712,22216,อภ.กระบุรี
1582,51370,50240,101610,26184,อภ.กระสัง
1583,7619,7349,14968,5163,อภ.กระแสสินธุ์
1584,3678,3359,7037,6688,อภ.กะทู้
1585,6653,6691,13344,5924,อภ.กะปง
1586,9591,9326,18917,4444,อภ.กะพ้อ
1587,10044,10377,20421,7930,อภ.กะเปอร์
1588,37660,37440,75100,23967,อภ.กันตัง
1589,91708,91997,183705,51006,อภ.กันทรลักษ์
1590,28331,27465,55796,16208,อภ.กันทรวิชัย
1591,46880,46643,93523,24121,อภ.กันทรารมย์
1592,6147,6552,12699,4250,อภ.กัลยาณิวัฒนา
1593,40480,39726,80206,32848,อภ.กาญจนดิษฐ์
1594,12341,12931,25272,7053,อภ.กาบัง
1595,29930,30107,60037,18484,อภ.กาบเชิง
1596,62145,58219,120364,38863,อภ.กำแพงแสน
1597,30877,30974,61851,20744,อภ.กุฉินารายณ์
1598,18408,18400,36808,9457,อภ.กุดข้าวปุ้น
1599,21776,21977,43753,13104,อภ.กุดจับ
1600,30479,30996,61475,19532,อภ.กุดชุม
1601,13736,14077,27813,8835,อภ.กุดบาก
1602,18388,18647,37035,10579,อภ.กุดรัง
1603,37506,36930,74436,21462,อภ.กุมภวาปี
1604,17683,17177,34860,11142,อภ.กุยบุรี
1605,21825,21727,43552,13419,อภ.กุสุมาลย์
1606,10987,11123,22110,6778,อภ.กู่แก้ว
1607,10346,10068,20414,9456,อภ.ขนอม
1608,12883,12537,25420,10040,อภ.ขลุง
1609,34787,34325,69112,25743,อภ.ขาณุวรลักษบุรี
1610,13191,12656,25847,8360,อภ.ขามทะเลสอ
1611,16697,16643,33340,9774,อภ.ขามสะแกแสง
1612,73014,72242,145256,35222,อภ.ขุขันธ์
1613,7193,6890,14083,5504,อภ.ขุนตาล
1614,9719,10333,20052,7622,อภ.ขุนยวม
1615,34709,34364,69073,18032,อภ.ขุนหาญ
1616,37734,36744,74478,21133,อภ.คง
1617,40681,39761,80442,30259,อภ.ครบุรี
1618,28633,27560,56193,23406,อภ.คลองขลุง
1619,35229,36270,71499,24667,อภ.คลองท่อม
1620,19537,20282,39819,14910,อภ.คลองลาน
1621,77063,69797,146860,68683,อภ.คลองหลวง
1622,5805,6279,12084,5073,อภ.คลองหอยโข่ง
1623,19410,19475,38885,13477,อภ.คลองหาด
1624,6537,6222,12759,4399,อภ.คลองเขื่อน
1625,7326,7360,14686,5402,อภ.คลองใหญ่
1626,17622,17754,35376,11917,อภ.ควนกาหลง
1627,41178,38021,79199,29999,อภ.ควนขนุน
1628,15332,14755,30087,9769,อภ.ควนเนียง
1629,10895,10720,21615,5977,อภ.ควนโดน
1630,24336,23938,48274,17836,อภ.คอนสวรรค์
1631,20596,20337,40933,13892,อภ.คอนสาร
1632,22341,22294,44635,14350,อภ.คำชะอี
1633,16415,16388,32803,11516,อภ.คำตากล้า
1634,13415,13474,26889,7348,อภ.คำม่วง
1635,30941,31071,62012,19019,อภ.คำเขื่อนแก้ว
1636,23340,22789,46129,14276,อภ.คีรีมาศ
1637,21159,21035,42194,16953,อภ.คีรีรัฐนิคม
1638,12117,12303,24420,10176,อภ.คุระบุรี
1639,29555,29716,59271,16135,อภ.คูเมือง
1640,13403,12443,25846,8821,อภ.ค่ายบางระจัน
1641,10420,10296,20716,5407,อภ.ค้อวัง
1642,13497,13212,26709,7449,อภ.ฆ้องชัย
1643,24607,24528,49135,17956,อภ.งาว
1644,25731,25395,51126,13753,อภ.จตุรพักตรพิมาน
1645,28919,28057,56976,19855,อภ.จอมทอง
1646,29009,28308,57317,19183,อภ.จอมบึง
1647,27268,27416,54684,13851,อภ.จอมพระ
1648,50914,50202,101116,27516,อภ.จะนะ
1649,19317,19969,39286,9674,อภ.จะแนะ
1650,33853,33687,67540,19156,อภ.จักราช
1651,19449,18978,38427,12059,อภ.จังหาร
1652,35138,33183,68321,24667,อภ.จัตุรัส
1653,9641,8750,18391,7144,อภ.จุน
1654,15952,15484,31436,10679,อภ.จุฬาภรณ์
1655,27465,26066,53531,19321,อภ.ฉวาง
1656,20279,19627,39906,11520,อภ.ชนบท
1657,34086,34146,68232,27799,อภ.ชนแดน
1658,41547,40892,82439,29715,อภ.ชะอวด
1659,11070,10891,21961,8503,อภ.ชะอำ
1660,37182,36423,73605,27833,อภ.ชัยบาดาล
1661,13982,14195,28177,11205,อภ.ชัยบุรี
1662,17708,18145,35853,12257,อภ.ชาติตระการ
1663,19263,19386,38649,11613,อภ.ชานุมาน
1664,17714,17680,35394,9058,อภ.ชำนิ
1665,12494,12110,24604,6905,อภ.ชื่นชม
1666,9078,8942,18020,6400,อภ.ชุมตาบง
1667,34287,34554,68841,18659,อภ.ชุมพลบุรี
1668,37152,36844,73996,19968,อภ.ชุมพวง
1669,41774,41978,83752,25542,อภ.ชุมแพ
1670,27552,25948,53500,19299,อภ.ชุมแสง
1671,14468,13964,28432,10925,อภ.ช้างกลาง
1672,7649,7886,15535,5631,อภ.ซับใหญ่
1673,9233,8996,18229,5226,อภ.ซำสูง
1674,19327,19603,38930,12102,อภ.ดงหลวง
1675,8838,8532,17370,6239,อภ.ดงเจริญ
1676,19679,18689,38368,14720,อภ.ดอกคำใต้
1677,13090,12995,26085,7550,อภ.ดอนจาน
1678,19297,19479,38776,11507,อภ.ดอนตาล
1679,17902,17185,35087,10927,อภ.ดอนตูม
1680,1025,967,1992,658,อภ.ดอนพุด
1681,13530,13717,27247,7897,อภ.ดอนมดแดง
1682,12476,12423,24899,10377,อภ.ดอนสัก
1683,20840,19594,40434,14412,อภ.ดอนเจดีย์
1684,24119,22251,46370,21860,อภ.ดอยสะเก็ด
1685,9326,9382,18708,8615,อภ.ดอยหลวง
1686,12931,12229,25160,11522,อภ.ดอยหล่อ
1687,11484,11502,22986,8684,อภ.ดอยเต่า
1688,38049,35621,73670,23203,อภ.ดำเนินสะดวก
1689,55422,54124,109546,34385,อภ.ด่านขุนทด
1690,31108,30415,61523,23590,อภ.ด่านช้าง
1691,23616,24346,47962,15892,อภ.ด่านซ้าย
1692,15559,15637,31196,10941,อภ.ด่านมะขามเตี้ย
1693,15382,14492,29874,10153,อภ.ตรอน
1694,56087,56649,112736,29495,อภ.ตระการพืชผล
1695,19657,19828,39485,15802,อภ.ตะกั่วทุ่ง
1696,21136,20771,41907,23677,อภ.ตะกั่วป่า
1697,23172,22108,45280,15874,อภ.ตะพานหิน
1698,7216,7068,14284,4681,อภ.ตะโหมด
1699,17393,16792,34185,12604,อภ.ตากฟ้า
1700,27412,26691,54103,11914,อภ.ตากใบ
1701,39354,38571,77925,29788,อภ.ตาคลี
1702,27226,27359,54585,16009,อภ.ตาพระยา
1703,14720,15152,29872,8232,อภ.ตาลสุม
1704,47243,44683,91926,69914,อภ.ถลาง
1705,9668,9635,19303,7396,อภ.ถ้ำพรรณรา
1706,6954,6997,13951,4160,อภ.ทรายทองวัฒนา
1707,12296,12329,24625,7810,อภ.ทรายมูล
1708,31815,34435,66250,27539,อภ.ทองผาภูมิ
1709,13504,13275,26779,9424,อภ.ทองแสนขัน
1710,17232,16633,33865,12531,อภ.ทับคล้อ
1711,12537,12553,25090,8055,อภ.ทับปุด
1712,21835,21296,43131,14838,อภ.ทับสะแก
1713,8167,7796,15963,5393,อภ.ทัพทัน
1714,7740,7857,15597,5190,อภ.ทุ่งช้าง
1715,10696,10728,21424,9561,อภ.ทุ่งตะโก
1716,12368,12686,25054,7163,อภ.ทุ่งฝน
1717,12682,12284,24966,5854,อภ.ทุ่งยางแดง
1718,14428,14774,29202,8957,อภ.ทุ่งศรีอุดม
1719,57518,59712,117230,47358,อภ.ทุ่งสง
1720,10514,10594,21108,6649,อภ.ทุ่งหว้า
1721,8793,8842,17635,6428,อภ.ทุ่งหัวช้าง
1722,11744,11524,23268,6372,อภ.ทุ่งเขาหลวง
1723,21163,20690,41853,14656,อภ.ทุ่งเสลี่ยม
1724,34936,34638,69574,24071,อภ.ทุ่งใหญ่
1725,14463,14428,28891,8141,อภ.ท่าคันโท
1726,14513,14716,29229,12914,อภ.ท่าฉาง
1727,25790,25965,51755,22480,อภ.ท่าชนะ
1728,2894,2567,5461,1840,อภ.ท่าช้าง
1729,23199,23625,46824,17009,อภ.ท่าตะเกียบ
1730,30915,29605,60520,23482,อภ.ท่าตะโก
1731,45774,46021,91795,23399,อภ.ท่าตูม
1732,30967,30242,61209,18399,อภ.ท่าบ่อ
1733,14576,14429,29005,10161,อภ.ท่าปลา
1734,46422,43725,90147,30600,อภ.ท่ามะกา
1735,29739,28008,57747,23611,อภ.ท่าม่วง
1736,25034,23770,48804,19740,อภ.ท่ายาง
1737,13062,13044,26106,9926,อภ.ท่าลี่
1738,22657,22702,45359,14490,อภ.ท่าวังผา
1739,22906,21244,44150,15308,อภ.ท่าวุ้ง
1740,59385,55813,115198,35793,อภ.ท่าศาลา
1741,44035,46635,90670,23858,อภ.ท่าสองยาง
1742,13027,12758,25785,9324,อภ.ท่าหลวง
1743,27229,27535,54764,15669,อภ.ท่าอุเทน
1744,16307,14879,31186,11162,อภ.ท่าเรือ
1745,41280,41127,82407,35258,อภ.ท่าแซะ
1746,14951,14703,29654,8716,อภ.ท่าแพ
1747,24439,23355,47794,17881,อภ.ท่าใหม่
1748,22386,22916,45302,20768,อภ.ท้ายเหมือง
1749,18761,18846,37607,11211,อภ.ธวัชบุรี
1750,36373,35912,72285,21867,อภ.ธาตุพนม
1751,11504,12568,24072,9015,อภ.ธารโต
1752,53175,48205,101380,39072,อภ.นครชัยศรี
1753,11469,10474,21943,11363,อภ.นครหลวง
1754,33738,33459,67197,23603,อภ.นครไทย
1755,16757,16804,33561,11983,อภ.นบพิตำ
1756,33247,33642,66889,18437,อภ.นากลาง
1757,12915,12889,25804,8096,อภ.นาคู
1758,47231,45899,93130,26187,อภ.นางรอง
1759,25392,26029,51421,17704,อภ.นาจะหลวย
1760,22021,21804,43825,17467,อภ.นาดี
1761,16349,16307,32656,8589,อภ.นาดูน
1762,4859,4935,9794,3584,อภ.นาด้วง
1763,19180,19238,38418,11183,อภ.นาตาล
1764,11738,11879,23617,7390,อภ.นาทม
1765,31112,31928,63040,19417,อภ.นาทวี
1766,14904,15009,29913,10327,อภ.นาน้อย
1767,12263,11947,24210,8497,อภ.นาบอน
1768,14807,14649,29456,9305,อภ.นามน
1769,15879,14917,30796,11891,อภ.นายายอาม
1770,14174,14482,28656,9643,อภ.นายูง
1771,15226,15246,30472,8631,อภ.นาวัง
1772,7075,7263,14338,4481,อภ.นาหมื่น
1773,11857,11076,22933,8987,อภ.นาหม่อม
1774,19950,19935,39885,12958,อภ.นาหว้า
1775,28620,28540,57160,17121,อภ.นาเชือก
1776,10090,10807,20897,7056,อภ.นาเยีย
1777,36418,35934,72352,21390,อภ.นาแก
1778,4812,4848,9660,3057,อภ.นาแห้ว
1779,14467,14153,28620,7900,อภ.นาโพธิ์
1780,21191,19938,41129,13405,อภ.นาโยง
1781,17026,17053,34079,10013,อภ.นิคมคำสร้อย
1782,7432,7448,14880,4578,อภ.นิคมน้ำอูน
1783,10246,10076,20322,15638,อภ.นิคมพัฒนา
1784,16461,16812,33273,10832,อภ.น้ำขุ่น
1785,16626,16683,33309,11934,อภ.น้ำปาด
1786,37026,36583,73609,21950,อภ.น้ำพอง
1787,30185,31034,61219,20534,อภ.น้ำยืน
1788,9045,9535,18580,7071,อภ.น้ำหนาว
1789,21888,22441,44329,11191,อภ.น้ำเกลี้ยง
1790,20335,20865,41200,13191,อภ.น้ำโสม
1791,50868,50725,101593,34018,อภ.บรบือ
1792,41624,39889,81513,28538,อภ.บรรพตพิสัย
1793,27413,28508,55921,15689,อภ.บันนังสตา
1794,10826,10742,21568,6354,อภ.บัวลาย
1795,17143,17797,34940,9695,อภ.บัวเชด
1796,33784,33876,67660,18938,อภ.บัวใหญ่
1797,18175,15472,33647,19019,อภ.บางกรวย
1798,16809,15918,32727,11545,อภ.บางกระทุ่ม
1799,5046,4920,9966,3394,อภ.บางกล่ำ
1800,23431,23884,47315,16553,อภ.บางขัน
1801,14344,13041,27385,9863,อภ.บางคนที
1802,15735,14828,30563,12527,อภ.บางคล้า
1803,7050,6919,13969,4455,อภ.บางซ้าย
1804,36647,36172,72819,21667,อภ.บางน้ำเปรี้ยว
1805,99366,87017,186383,96585,อภ.บางบัวทอง
1806,7510,6938,14448,5433,อภ.บางบาล
1807,47569,44979,92548,45054,อภ.บางบ่อ
1808,30311,28782,59093,19645,อภ.บางปลาม้า
1809,28576,27581,56157,26333,อภ.บางปะกง
1810,18857,17576,36433,12530,อภ.บางปะหัน
1811,26718,24351,51069,26825,อภ.บางปะอิน
1812,139290,123636,262926,165989,อภ.บางพลี
1813,10624,9970,20594,7873,อภ.บางมูลนาก
1814,37872,36618,74490,25986,อภ.บางระกำ
1815,10032,9412,19444,7070,อภ.บางระจัน
1816,15075,13429,28504,18127,อภ.บางละมุง
1817,30985,30502,61487,26329,อภ.บางสะพาน
1818,18356,18335,36691,16029,อภ.บางสะพานน้อย
1819,40257,39296,79553,28677,อภ.บางเลน
1820,30461,28582,59043,43802,อภ.บางเสาธง
1821,8990,8853,17843,6387,อภ.บางแก้ว
1822,9327,8584,17911,6532,อภ.บางแพ
1823,55017,47495,102512,51485,อภ.บางใหญ่
1824,16290,15491,31781,10554,อภ.บางไทร
1825,20868,20264,41132,9376,อภ.บาเจาะ
1826,20574,20128,40702,13399,อภ.บำเหน็จณรงค์
1827,14642,14124,28766,10745,อภ.บึงนาราง
1828,2191,2186,4377,1080,อภ.บึงบูรพ์
1829,31725,31148,62873,25452,อภ.บึงสามพัน
1830,9188,9133,18321,7245,อภ.บึงสามัคคี
1831,13851,14043,27894,8821,อภ.บึงโขงหลง
1832,38304,39413,77717,24339,อภ.บุณฑริก
1833,7011,7001,14012,4176,อภ.บุ่งคล้า
1834,18691,18978,37669,13367,อภ.บ่อทอง
1835,24150,24064,48214,18508,อภ.บ่อพลอย
1836,7448,7790,15238,4903,อภ.บ่อเกลือ
1837,8991,9697,18688,7576,อภ.บ่อไร่
1838,20658,20533,41191,11296,อภ.บ้านกรวด
1839,12343,12943,25286,9586,อภ.บ้านคา
1840,33887,32326,66213,33972,อภ.บ้านค่าย
1841,4977,5572,10549,4621,อภ.บ้านฉาง
1842,55624,55952,111576,32445,อภ.บ้านดุง
1843,9536,9291,18827,4555,อภ.บ้านด่าน
1844,22131,22187,44318,14312,อภ.บ้านด่านลานหอย
1845,15818,15569,31387,10829,อภ.บ้านตาก
1846,4591,4557,9148,3888,อภ.บ้านตาขุน
1847,4212,3863,8075,3355,อภ.บ้านธิ
1848,32244,32267,64511,23901,อภ.บ้านนา
1849,25857,25174,51031,18180,อภ.บ้านนาสาร
1850,10515,10305,20820,7681,อภ.บ้านนาเดิม
1851,41793,40611,82404,44781,อภ.บ้านบึง
1852,51062,51148,102210,30683,อภ.บ้านผือ
1853,25297,25087,50384,16942,อภ.บ้านฝาง
1854,33351,33983,67334,19669,อภ.บ้านม่วง
1855,25184,23086,48270,15724,อภ.บ้านลาด
1856,14132,13616,27748,9598,อภ.บ้านสร้าง
1857,16221,15335,31556,12275,อภ.บ้านหมอ
1858,36195,33524,69719,25041,อภ.บ้านหมี่
1859,5757,5785,11542,3949,อภ.บ้านหลวง
1860,21365,20905,42270,14558,อภ.บ้านเขว้า
1861,8691,8569,17260,5060,อภ.บ้านเหลื่อม
1862,20716,20393,41109,11591,อภ.บ้านแท่น
1863,13122,13399,26521,7999,อภ.บ้านแพง
1864,3662,3189,6851,2665,อภ.บ้านแพรก
1865,26075,23981,50056,15560,อภ.บ้านแพ้ว
1866,18540,17776,36316,11465,อภ.บ้านแหลม
1867,13169,12912,26081,8231,อภ.บ้านแฮด
1868,5173,5330,10503,4457,อภ.บ้านโคก
1869,50562,46512,97074,36712,อภ.บ้านโป่ง
1870,23719,22119,45838,20602,อภ.บ้านโพธิ์
1871,13350,12708,26058,10201,อภ.บ้านโฮ่ง
1872,11254,10979,22233,6043,อภ.บ้านใหม่ไชยพจน์
1873,36436,35928,72364,22582,อภ.บ้านไผ่
1874,31914,31566,63480,24536,อภ.บ้านไร่
1875,19670,19831,39501,12375,อภ.ปง
1876,23762,23483,47245,12769,อภ.ปทุมรัตต์
1877,22579,22937,45516,13382,อภ.ปทุมราชวงศา
1878,12768,12804,25572,7193,อภ.ประจักษ์ศิลปาคม
1879,25618,24334,49952,16945,อภ.ประจันตคาม
1880,35927,35512,71439,19243,อภ.ประทาย
1881,62784,62413,125197,35969,อภ.ประโคนชัย
1882,31890,31663,63553,15074,อภ.ปรางค์กู่
1883,24790,28750,53540,27075,อภ.ปราณบุรี
1884,72881,71369,144250,41680,อภ.ปราสาท
1885,33947,35317,69264,94541,อภ.ปลวกแดง
1886,25097,25368,50465,16217,อภ.ปลาปาก
1887,16185,16226,32411,10959,อภ.ปลายพระยา
1888,19197,19260,38457,11766,อภ.ปะคำ
1889,20205,19799,40004,17906,อภ.ปะทิว
1890,18706,17928,36634,9536,อภ.ปะนาเระ
1891,31899,31083,62982,21459,อภ.ปะเหลียน
1892,47375,45193,92568,32039,อภ.ปักธงชัย
1893,27062,26778,53840,15914,อภ.ปัว
1894,14008,14089,28097,9535,อภ.ปากคาด
1895,16437,17077,33514,11152,อภ.ปากชม
1896,62712,61707,124419,66800,อภ.ปากช่อง
1897,26154,25061,51215,18512,อภ.ปากท่อ
1898,38856,39401,78257,25868,อภ.ปากพนัง
1899,11554,10858,22412,8471,อภ.ปากพลี
1900,16650,16174,32824,11004,อภ.ปากพะยูน
1901,26245,23495,49740,23589,อภ.ปากเกร็ด
1902,10518,11185,21703,8597,อภ.ปางมะผ้า
1903,15223,15181,30404,11049,อภ.ปางศิลาทอง
1904,16874,18176,35050,14988,อภ.ปาย
1905,14835,13912,28747,12815,อภ.ป่าซาง
1906,16002,15973,31975,9993,อภ.ป่าติ้ว
1907,22094,21713,43807,15726,อภ.ป่าบอน
1908,13932,13286,27218,10717,อภ.ป่าพะยอม
1909,5985,5893,11878,4044,อภ.ป่าแดด
1910,9907,8989,18896,6665,อภ.ป่าโมก
1911,11565,10822,22387,7271,อภ.ผักไห่
1912,15507,15589,31096,8428,อภ.ผาขาว
1913,56609,55506,112115,40555,อภ.ฝาง
1914,13790,13625,27415,9667,อภ.พญาเม็งราย
1915,12004,12477,24481,9370,อภ.พนม
1916,18755,19254,38009,12246,อภ.พนมดงรัก
1917,16714,15899,32613,11130,อภ.พนมทวน
1918,36471,34578,71049,29929,อภ.พนมสารคาม
1919,30314,30161,60475,17566,อภ.พนมไพร
1920,51971,48967,100938,36074,อภ.พนัสนิคม
1921,9503,9659,19162,6545,อภ.พนา
1922,40717,42340,83057,20064,อภ.พบพระ
1923,40009,39583,79592,21667,อภ.พยัคฆภูมิพิสัย
1924,25670,24327,49997,21002,อภ.พยุหะคีรี
1925,15809,15470,31279,8184,อภ.พยุห์
1926,39245,38756,78001,26445,อภ.พรรณานิคม
1927,13856,13449,27305,8957,อภ.พรหมคีรี
1928,8760,7894,16654,5912,อภ.พรหมบุรี
1929,41696,39703,81399,30550,อภ.พรหมพิราม
1930,18450,18198,36648,12012,อภ.พระทองคำ
1931,36800,33680,70480,24750,อภ.พระนครศรีอยุธยา
1932,20191,18613,38804,13440,อภ.พระประแดง
1933,22559,21935,44494,16285,อภ.พระพรหม
1934,12560,11881,24441,9739,อภ.พระพุทธบาท
1935,12710,12172,24882,7547,อภ.พระยืน
1936,59376,55233,114609,53227,อภ.พระสมุทรเจดีย์
1937,31206,31493,62699,24170,อภ.พระแสง
1938,24351,24381,48732,16207,อภ.พรานกระต่าย
1939,14337,14535,28872,8037,อภ.พรเจริญ
1940,18873,18434,37307,15526,อภ.พร้าว
1941,38320,37553,75873,22503,อภ.พล
1942,13620,14162,27782,7056,อภ.พลับพลาชัย
1943,11279,11789,23068,10702,อภ.พะโต๊ะ
1944,23347,22764,46111,17283,อภ.พังโคน
1945,27387,26635,54022,23220,อภ.พัฒนานิคม
1946,57917,54838,112755,47738,อภ.พาน
1947,23667,22913,46580,36276,อภ.พานทอง
1948,37030,34974,72004,25630,อภ.พิชัย
1949,51696,52558,104254,33966,อภ.พิบูลมังสาหาร
1950,12388,12257,24645,8259,อภ.พิบูลย์รักษ์
1951,9186,8903,18089,7274,อภ.พิปูน
1952,61133,59273,120406,38785,อภ.พิมาย
1953,11603,9838,21441,11612,อภ.พุทธมณฑล
1954,21333,20427,41760,12159,อภ.พุทไธสง
1955,37235,37313,74548,35363,อภ.พุนพิน
1956,6889,6536,13425,5068,อภ.ฟากท่า
1957,15270,15655,30925,11996,อภ.ภักดีชุมพล
1958,13225,12445,25670,8149,อภ.ภาชี
1959,13517,13748,27265,8669,อภ.ภูกระดึง
1960,6615,6108,12723,4993,อภ.ภูกามยาว
1961,12290,12110,24400,9425,อภ.ภูซาง
1962,9796,9873,19669,5806,อภ.ภูผาม่าน
1963,17809,18151,35960,12338,อภ.ภูพาน
1964,27130,27536,54666,15810,อภ.ภูสิงห์
1965,12382,12663,25045,7690,อภ.ภูหลวง
1966,55127,53664,108791,35086,อภ.ภูเขียว
1967,18166,17856,36022,13548,อภ.ภูเพียง
1968,9678,10051,19729,7198,อภ.ภูเรือ
1969,34652,34289,68941,20205,อภ.ภูเวียง
1970,24837,24640,49477,21846,อภ.มวกเหล็ก
1971,25742,25769,51511,14271,อภ.มหาชนะชัย
1972,7028,6396,13424,5023,อภ.มหาราช
1973,15474,15127,30601,13275,อภ.มะขาม
1974,9036,9473,18509,6319,อภ.มะนัง
1975,33679,33200,66879,21379,อภ.มัญจาคีรี
1976,28395,27714,56109,12716,อภ.มายอ
1977,12440,11421,23861,8792,อภ.มโนรมย์
1978,40729,40852,81581,22566,อภ.ม่วงสามสิบ
1979,44930,44803,89733,21773,อภ.ยะรัง
1980,35257,34921,70178,15895,อภ.ยะหริ่ง
1981,30563,30778,61341,14407,อภ.ยะหา
1982,14767,14937,29704,7510,อภ.ยางชุมน้อย
1983,41523,40198,81721,24056,อภ.ยางตลาด
1984,17664,17479,35143,9676,อภ.ยางสีสุราช
1985,22319,21732,44051,10454,อภ.ยี่งอ
1986,28830,27834,56664,17741,อภ.ย่านตาขาว
1987,39706,38375,78081,17399,อภ.ระแงะ
1988,24602,23970,48572,19310,อภ.ระโนด
1989,43599,43378,86977,22625,อภ.รัตนบุรี
1990,18926,19064,37990,12932,อภ.รัตนวาปี
1991,34025,33583,67608,21813,อภ.รัตภูมิ
1992,13695,13301,26996,9829,อภ.รัษฎา
1993,6460,6205,12665,4692,อภ.ราชสาส์น
1994,43701,42788,86489,20622,อภ.รามัน
1995,38018,37825,75843,19997,อภ.ราษีไศล
1996,33352,33114,66466,15681,อภ.รือเสาะ
1997,5291,5183,10474,3251,อภ.ร่องคำ
1998,30837,30654,61491,20042,อภ.ร่อนพิบูลย์
1999,18430,17132,35562,12559,อภ.ร้องกวาง
2000,15413,15257,30670,11356,อภ.ลอง
2001,34388,34087,68475,20869,อภ.ละงู
2002,9684,9786,19470,5707,อภ.ละหานทราย
2003,6116,6326,12442,5510,อภ.ละอุ่น
2004,13146,13254,26400,11781,อภ.ละแม
2005,18369,18032,36401,14967,อภ.ลับแล
2006,15057,14664,29721,9578,อภ.ลาดบัวหลวง
2007,37609,36176,73785,27641,อภ.ลาดยาว
2008,30107,28778,58885,29565,อภ.ลาดหลุมแก้ว
2009,16435,16366,32801,11122,อภ.ลานกระบือ
2010,20146,19160,39306,14466,อภ.ลานสกา
2011,27847,27596,55443,18767,อภ.ลานสัก
2012,13423,13395,26818,7043,อภ.ลำดวน
2013,14108,13971,28079,7481,อภ.ลำทะเมนชัย
2014,10024,10264,20288,7291,อภ.ลำทับ
2015,57473,57352,114825,30838,อภ.ลำปลายมาศ
2016,44025,41296,85321,41769,อภ.ลำลูกกา
2017,13671,13580,27251,10329,อภ.ลำสนธิ
2018,30626,31028,61654,21165,อภ.ลี้
2019,17253,16980,34233,9604,อภ.ลืออำนาจ
2020,15703,15342,31045,10897,อภ.วชิรบารมี
2021,11250,11067,22317,10978,อภ.วังจันทร์
2022,21381,21236,42617,15226,อภ.วังชิ้น
2023,8841,8682,17523,5842,อภ.วังทรายพูน
2024,57818,56618,114436,43228,อภ.วังทอง
2025,28382,26999,55381,25227,อภ.วังน้อย
2026,21730,21619,43349,19004,อภ.วังน้ำเขียว
2027,20215,20356,40571,14995,อภ.วังน้ำเย็น
2028,5923,5678,11601,4565,อภ.วังม่วง
2029,7693,7796,15489,4682,อภ.วังยาง
2030,20347,20102,40449,13916,อภ.วังวิเศษ
2031,12655,12721,25376,10312,อภ.วังสมบูรณ์
2032,50439,49878,100317,33760,อภ.วังสะพุง
2033,15606,15850,31456,8641,อภ.วังสามหมอ
2034,19857,20211,40068,9432,อภ.วังหิน
2035,14994,15118,30112,9102,อภ.วังเจ้า
2036,18414,18568,36982,13196,อภ.วังเหนือ
2037,14308,14057,28365,9215,อภ.วังโป่ง
2038,38006,38494,76500,26653,อภ.วัฒนานคร
2039,11418,10658,22076,8976,อภ.วัดสิงห์
2040,5658,5122,10780,3624,อภ.วัดเพลง
2041,14929,14632,29561,11136,อภ.วัดโบสถ์
2042,60437,59962,120399,34039,อภ.วานรนิวาส
2043,54062,53444,107506,30363,อภ.วาปีปทุม
2044,18251,17800,36051,12143,อภ.วาริชภูมิ
2045,46457,45916,92373,30328,อภ.วารินชำราบ
2046,7521,8137,15658,7312,อภ.วิภาวดี
2047,16910,16229,33139,11969,อภ.วิหารแดง
2048,50724,49625,100349,33391,อภ.วิเชียรบุรี
2049,26492,24513,51005,18066,อภ.วิเศษชัยชาญ
2050,23244,23591,46835,11511,อภ.ศรีณรงค์
2051,11915,11788,23703,6619,อภ.ศรีธาตุ
2052,11581,11009,22590,8157,อภ.ศรีนคร
2053,5320,5138,10458,3604,อภ.ศรีนครินทร์
2054,8976,9008,17984,6869,อภ.ศรีบรรพต
2055,44876,45618,90494,24946,อภ.ศรีบุญเรือง
2056,21094,19285,40379,14997,อภ.ศรีประจันต์
2057,37134,35644,72778,50971,อภ.ศรีมหาโพธิ
2058,6755,6510,13265,6358,อภ.ศรีมโหสถ
2059,24393,24158,48551,11513,อภ.ศรีรัตนะ
2060,27877,27915,55792,46958,อภ.ศรีราชา
2061,14347,14558,28905,9469,อภ.ศรีวิไล
2062,32376,32152,64528,19186,อภ.ศรีสงคราม
2063,17292,18909,36201,10992,อภ.ศรีสมเด็จ
2064,12514,13305,25819,10010,อภ.ศรีสวัสดิ์
2065,35582,34333,69915,26755,อภ.ศรีสัชนาลัย
2066,17886,18422,36308,9408,อภ.ศรีสาคร
2067,32042,29585,61627,22418,อภ.ศรีสำโรง
2068,11951,11696,23647,7346,อภ.ศรีเชียงใหม่
2069,28628,28346,56974,19427,อภ.ศรีเทพ
2070,33137,33632,66769,19181,อภ.ศรีเมืองใหม่
2071,9809,9979,19788,5297,อภ.ศิลาลาด
2072,65575,64719,130294,32352,อภ.ศีขรภูมิ
2073,49549,49371,98920,27026,อภ.สตึก
2074,23127,22064,45191,13716,อภ.สทิงพระ
2075,19199,19450,38649,10610,อภ.สนม
2076,35268,35409,70677,22715,อภ.สนามชัยเขต
2077,10807,10505,21312,6604,อภ.สบปราบ
2078,22622,23368,45990,17050,อภ.สบเมย
2079,27745,27249,54994,17433,อภ.สมเด็จ
2080,31943,29454,61397,22100,อภ.สรรคบุรี
2081,15918,15020,30938,11652,อภ.สรรพยา
2082,6962,7148,14110,5244,อภ.สระโบสถ์
2083,13167,13374,26541,8200,อภ.สระใคร
2084,10911,10967,21878,6482,อภ.สร้างคอม
2085,22278,24272,46550,14477,อภ.สวนผึ้ง
2086,26216,24225,50441,20004,อภ.สวรรคโลก
2087,35160,34857,70017,32255,อภ.สวี
2088,15527,15646,31173,9133,อภ.สว่างวีระวงศ์
2089,15039,14946,29985,10929,อภ.สว่างอารมณ์
2090,64475,63787,128262,37085,อภ.สว่างแดนดิน
2091,17426,17205,34631,10211,อภ.สหัสขันธ์
2092,21574,20786,42360,16078,อภ.สอง
2093,56363,54305,110668,35842,อภ.สองพี่น้อง
2094,5996,6413,12409,3780,อภ.สองแคว
2095,18548,18909,37457,14953,อภ.สอยดาว
2096,38753,39761,78514,19054,อภ.สะบ้าย้อย
2097,29123,29409,58532,21237,อภ.สะเดา
2098,8967,9302,18269,6038,อภ.สะเมิง
2099,20312,21761,42073,12201,อภ.สังขละบุรี
2100,63153,63891,127044,34340,อภ.สังขะ
2101,10948,11288,22236,7139,อภ.สังคม
2102,26156,26086,52242,29194,อภ.สัตหีบ
2103,22577,20207,42784,22383,อภ.สันกำแพง
2104,7660,8046,15706,5102,อภ.สันติสุข
2105,10695,9462,20157,10016,อภ.สันทราย
2106,31623,28172,59795,25432,อภ.สันป่าตอง
2107,9115,8995,18110,6086,อภ.สากเหล็ก
2108,13007,12797,25804,8734,อภ.สามง่าม
2109,12505,12907,25412,7510,อภ.สามชัย
2110,20766,19155,39921,14744,อภ.สามชุก
2111,52195,47276,99471,49095,อภ.สามพราน
2112,15840,15642,31482,12266,อภ.สามร้อยยอด
2113,13035,12683,25718,9447,อภ.สามเงา
2114,4340,4072,8412,2833,อภ.สามโก้
2115,23140,21709,44849,19446,อภ.สามโคก
2116,28910,27741,56651,13457,อภ.สายบุรี
2117,24611,21693,46304,22364,อภ.สารภี
2118,27035,27124,54159,14544,อภ.สำโรง
2119,25092,25262,50354,11752,อภ.สำโรงทาบ
2120,22594,21531,44125,14664,อภ.สิงหนคร
2121,41128,40558,81686,28665,อภ.สิชล
2122,21230,22038,43268,14327,อภ.สิรินธร
2123,17193,17523,34716,12505,อภ.สิเกา
2124,43524,42948,86472,31766,อภ.สีคิ้ว
2125,37320,36840,74160,22189,อภ.สีชมพู
2126,10096,10043,20139,5855,อภ.สีดา
2127,7176,7160,14336,4528,อภ.สุขสำราญ
2128,11265,11713,22978,7392,อภ.สุคิริน
2129,26763,26950,53713,14997,อภ.สุวรรณคูหา
2130,53069,52496,105565,29543,อภ.สุวรรณภูมิ
2131,24403,23733,48136,12081,อภ.สุไหงปาดี
2132,19433,18157,37590,10994,อภ.สุไหงโกลก
2133,37001,35331,72332,29210,อภ.สูงเนิน
2134,36121,33154,69275,27792,อภ.สูงเม่น
2135,14503,15017,29520,7654,อภ.ส่องดาว
2136,28441,28778,57219,15337,อภ.หนองกี่
2137,25569,25608,51177,15185,อภ.หนองกุงศรี
2138,8077,7263,15340,5773,อภ.หนองขาหย่าง
2139,29583,29347,58930,13296,อภ.หนองจิก
2140,17566,16571,34137,11772,อภ.หนองฉาง
2141,11968,11812,23780,6631,อภ.หนองนาคำ
2142,27476,27009,54485,23201,อภ.หนองบัว
2143,16210,16433,32643,11481,อภ.หนองบัวระเหว
2144,46333,46669,93002,29387,อภ.หนองบัวแดง
2145,30643,30150,60793,18389,อภ.หนองบุญมาก
2146,13330,13707,27037,9492,อภ.หนองปรือ
2147,29896,30143,60039,16405,อภ.หนองพอก
2148,6503,6326,12829,5093,อภ.หนองมะโมง
2149,14238,13671,27909,11480,อภ.หนองม่วง
2150,6852,6023,12875,5049,อภ.หนองม่วงไข่
2151,22399,22508,44907,11579,อภ.หนองวัวซอ
2152,35745,35319,71064,20412,อภ.หนองสองห้อง
2153,10424,10369,20793,7137,อภ.หนองสูง
2154,17596,17933,35529,9319,อภ.หนองหงส์
2155,8128,8172,16300,6743,อภ.หนองหญ้าปล้อง
2156,23680,22578,46258,16317,อภ.หนองหญ้าไซ
2157,44349,44438,88787,26880,อภ.หนองหาน
2158,10154,10394,20548,5998,อภ.หนองหิน
2159,12189,12190,24379,6495,อภ.หนองฮี
2160,42394,41471,83865,22879,อภ.หนองเรือ
2161,26046,25626,51672,16437,อภ.หนองเสือ
2162,34696,32902,67598,33527,อภ.หนองแค
2163,6795,6196,12991,4335,อภ.หนองแซง
2164,11661,11655,23316,6715,อภ.หนองแสง
2165,5914,5614,11528,4420,อภ.หนองโดน
2166,7665,7705,15370,6594,อภ.หนองใหญ่
2167,38342,37970,76312,24954,อภ.หนองไผ่
2168,28629,27458,56087,23726,อภ.หลังสวน
2169,73936,70613,144549,48644,อภ.หล่มสัก
2170,30715,29521,60236,18739,อภ.หล่มเก่า
2171,9856,9903,19759,6166,อภ.หว้านใหญ่
2172,21262,19938,41200,14492,อภ.หันคา
2173,21121,21221,42342,10842,อภ.หัวตะพาน
2174,27221,25423,52644,27972,อภ.หัวหิน
2175,22230,22018,44248,17631,อภ.หัวไทร
2176,39820,35444,75264,43174,อภ.หางดง
2177,8410,8493,16903,4855,อภ.หาดสำราญ
2178,15957,14760,30717,12806,อภ.หาดใหญ่
2179,17128,16598,33726,11723,อภ.ห้วยกระเจา
2180,10170,9960,20130,7408,อภ.ห้วยคต
2181,19395,19508,38903,8920,อภ.ห้วยทับทัน
2182,7099,6933,14032,3912,อภ.ห้วยผึ้ง
2183,39851,38792,78643,26655,อภ.ห้วยยอด
2184,16319,16106,32425,8164,อภ.ห้วยราช
2185,19928,20133,40061,11877,อภ.ห้วยเม็ก
2186,35007,35320,70327,19280,อภ.ห้วยแถลง
2187,24490,23153,47643,19312,อภ.ห้างฉัตร
2188,31637,30701,62338,21977,อภ.องครักษ์
2189,30145,30686,60831,22382,อภ.อมก๋อย
2190,37651,36420,74071,35808,อภ.อรัญประเทศ
2191,24983,23102,48085,15516,อภ.อัมพวา
2192,26893,27135,54028,18555,อภ.อากาศอำนวย
2193,34812,34854,69666,18768,อภ.อาจสามารถ
2194,25472,23564,49036,17555,อภ.อินทร์บุรี
2195,24224,22243,46467,21498,อภ.อุทัย
2196,51551,50923,102474,26147,อภ.อุทุมพรพิสัย
2197,15932,15559,31491,8186,อภ.อุบลรัตน์
2198,20847,22558,43405,11095,อภ.อุ้มผาง
2199,33558,31636,65194,21146,อภ.อู่ทอง
2200,23453,23248,46701,16328,อภ.อ่าวลึก
2201,12932,12631,25563,9622,อภ.ฮอด
2202,36798,36755,73553,20769,อภ.เกษตรวิสัย
2203,42899,42556,85455,24976,อภ.เกษตรสมบูรณ์
2204,1255,1354,2609,2020,อภ.เกาะกูด
2205,18716,17514,36230,13158,อภ.เกาะคา
2206,12870,13539,26409,8383,อภ.เกาะจันทร์
2207,4295,4301,8596,5978,อภ.เกาะช้าง
2208,5300,5484,10784,12194,อภ.เกาะพะงัน
2209,6772,6894,13666,5272,อภ.เกาะยาว
2210,17105,17501,34606,14403,อภ.เกาะลันตา
2211,14621,13960,28581,10488,อภ.เก้าเลี้ยว
2212,15783,15823,31606,8945,อภ.เขมราฐ
2213,17401,17012,34413,9954,อภ.เขวาสินรินทร์
2214,6469,6267,12736,5467,อภ.เขาคิชฌกูฏ
2215,17512,17553,35065,11797,อภ.เขาค้อ
2216,25369,25487,50856,16118,อภ.เขาฉกรรจ์
2217,11893,11776,23669,11002,อภ.เขาชะเมา
2218,15807,15189,30996,11443,อภ.เขาชัยสน
2219,24959,25153,50112,17956,อภ.เขาพนม
2220,12048,11473,23521,10176,อภ.เขาย้อย
2221,10550,10440,20990,8460,อภ.เขาวง
2222,20050,19885,39935,17646,อภ.เขาสมิง
2223,10744,10709,21453,6333,อภ.เขาสวนกวาง
2224,51887,50981,102868,27748,อภ.เขื่องใน
2225,13827,13886,27713,11194,อภ.เคียนซา
2226,18987,19305,38292,10474,อภ.เจริญศิลป์
2227,20503,20450,40953,9694,อภ.เจาะไอร้อง
2228,15187,14398,29585,12441,อภ.เฉลิมพระเกียรติ
2229,15836,15156,30992,9361,อภ.เฉลิมพระเกียรติ
2230,6050,6019,12069,3489,อภ.เฉลิมพระเกียรติ
2231,4791,5032,9823,3366,อภ.เฉลิมพระเกียรติ
2232,11219,11101,22320,7920,อภ.เฉลิมพระเกียรติ
2233,8837,8753,17590,5762,อภ.เชียงกลาง
2234,13925,13427,27352,8117,อภ.เชียงขวัญ
2235,12891,12413,25304,10431,อภ.เชียงของ
2236,19196,19028,38224,13862,อภ.เชียงคาน
2237,27869,27763,55632,21292,อภ.เชียงคำ
2238,13579,13010,26589,11389,อภ.เชียงดาว
2239,4945,4848,9793,3912,อภ.เชียงม่วน
2240,28411,27671,56082,17915,อภ.เชียงยืน
2241,24964,23754,48718,21354,อภ.เชียงแสน
2242,20235,20282,40517,14387,อภ.เชียรใหญ่
2243,36286,36919,73205,22627,อภ.เซกา
2244,65369,66198,131567,49666,อภ.เดชอุดม
2245,21528,20228,41756,15142,อภ.เดิมบางนางบวช
2246,9632,10072,19704,8371,อภ.เด่นชัย
2247,12164,12208,24372,8580,อภ.เต่างอย
2248,17066,16664,33730,11399,อภ.เถิน
2249,32451,33070,65521,23676,อภ.เทพสถิต
2250,29286,31087,60373,16505,อภ.เทพา
2251,12534,12771,25305,8445,อภ.เทพารักษ์
2252,37653,37186,74839,28705,อภ.เทิง
2253,5547,5319,10866,3938,อภ.เนินขาม
2254,19374,19153,38527,14635,อภ.เนินมะปราง
2255,13135,12842,25977,8428,อภ.เนินสง่า
2256,17849,18112,35961,9173,อภ.เบญจลักษ์
2257,17461,18591,36052,15649,อภ.เบตง
2258,7022,7187,14209,3802,อภ.เปือยน้อย
2259,20007,19963,39970,11424,อภ.เฝ้าไร่
2260,48210,48207,96417,29169,อภ.เพ็ญ
2261,11765,11446,23211,6832,อภ.เมยวดี
2262,37265,36409,73674,38326,อภ.เมืองกระบี่
2263,43461,55456,98917,38972,อภ.เมืองกาญจนบุรี
2264,40984,39872,80856,25719,อภ.เมืองกาฬสินธุ์
2265,68784,66737,135521,52519,อภ.เมืองกำแพงเพชร
2266,75580,72947,148527,65099,อภ.เมืองขอนแก่น
2267,24365,22092,46457,21762,อภ.เมืองจันทบุรี
2268,8818,9019,17837,4356,อภ.เมืองจันทร์
2269,62936,59968,122904,51158,อภ.เมืองฉะเชิงเทรา
2270,21136,20034,41170,26137,อภ.เมืองชลบุรี
2271,11814,11029,22843,8632,อภ.เมืองชัยนาท
2272,69912,66973,136885,53889,อภ.เมืองชัยภูมิ
2273,46472,45854,92326,44007,อภ.เมืองชุมพร
2274,49012,45759,94771,39876,อภ.เมืองตรัง
2275,38181,36133,74314,35026,อภ.เมืองตราด
2276,37423,37105,74528,29220,อภ.เมืองตาก
2277,42220,42248,84468,33854,อภ.เมืองนครนายก
2278,89749,82938,172687,66425,อภ.เมืองนครปฐม
2279,58543,59490,118033,35688,อภ.เมืองนครพนม
2280,120949,110227,231176,109748,อภ.เมืองนครราชสีมา
2281,79953,78087,158040,61795,อภ.เมืองนครศรีธรรมราช
2282,82180,77556,159736,69809,อภ.เมืองนครสวรรค์
2283,30820,26695,57515,30511,อภ.เมืองนนทบุรี
2284,42439,42135,84574,25961,อภ.เมืองนราธิวาส
2285,31301,31404,62705,24462,อภ.เมืองน่าน
2286,29194,29466,58660,18487,อภ.เมืองบึงกาฬ
2287,87196,86985,174181,52417,อภ.เมืองบุรีรัมย์
2288,67126,60902,128028,66691,อภ.เมืองปทุมธานี
2289,32461,32579,65040,26113,อภ.เมืองประจวบคีรีขันธ์
2290,42743,45576,88319,35262,อภ.เมืองปราจีนบุรี
2291,48214,43448,91662,30960,อภ.เมืองปัตตานี
2292,16393,16436,32829,11923,อภ.เมืองปาน
2293,22378,21102,43480,17322,อภ.เมืองพะเยา
2294,15916,15511,31427,12247,อภ.เมืองพังงา
2295,46067,42410,88477,33671,อภ.เมืองพัทลุง
2296,37658,35300,72958,26105,อภ.เมืองพิจิตร
2297,92778,86870,179648,84862,อภ.เมืองพิษณุโลก
2298,23210,20537,43747,30443,อภ.เมืองภูเก็ต
2299,51951,49872,101823,35596,อภ.เมืองมหาสารคาม
2300,39598,40076,79674,26572,อภ.เมืองมุกดาหาร
2301,38675,37643,76318,18681,อภ.เมืองยะลา
2302,9755,9951,19706,5457,อภ.เมืองยาง
2303,53685,54417,108102,38332,อภ.เมืองยโสธร
2304,34654,35580,70234,37744,อภ.เมืองระนอง
2305,51510,49968,101478,64483,อภ.เมืองระยอง
2306,63207,60034,123241,47697,อภ.เมืองราชบุรี
2307,55953,54417,110370,40996,อภ.เมืองร้อยเอ็ด
2308,51436,52238,103674,41105,อภ.เมืองลพบุรี
2309,45973,44554,90527,38173,อภ.เมืองลำปาง
2310,30961,27929,58890,27356,อภ.เมืองลำพูน
2311,44397,42760,87157,26287,อภ.เมืองศรีสะเกษ
2312,57161,55898,113059,41103,อภ.เมืองสกลนคร
2313,7933,7327,15260,5479,อภ.เมืองสงขลา
2314,33330,32447,65777,18364,อภ.เมืองสตูล
2315,66480,59997,126477,58292,อภ.เมืองสมุทรปราการ
2316,40920,37673,78593,31968,อภ.เมืองสมุทรสงคราม
2317,106186,97385,203571,113256,อภ.เมืองสมุทรสาคร
2318,6835,6818,13653,3755,อภ.เมืองสรวง
2319,21946,25302,47248,19624,อภ.เมืองสระบุรี
2320,43005,43535,86540,29275,อภ.เมืองสระแก้ว
2321,19462,17049,36511,13204,อภ.เมืองสิงห์บุรี
2322,56324,51215,107539,38078,อภ.เมืองสุพรรณบุรี
2323,9172,8707,17879,7371,อภ.เมืองสุราษฎร์ธานี
2324,109736,107881,217617,75576,อภ.เมืองสุรินทร์
2325,31649,29430,61079,22659,อภ.เมืองสุโขทัย
2326,37789,37186,74975,24063,อภ.เมืองหนองคาย
2327,50904,51202,102106,30604,อภ.เมืองหนองบัวลำภู
2328,48458,48644,97102,30848,อภ.เมืองอำนาจเจริญ
2329,93893,90115,184008,69678,อภ.เมืองอุดรธานี
2330,23551,22465,46016,17719,อภ.เมืองอุตรดิตถ์
2331,18472,17027,35499,13501,อภ.เมืองอุทัยธานี
2332,48438,47165,95603,35139,อภ.เมืองอุบลราชธานี
2333,22997,20742,43739,16782,อภ.เมืองอ่างทอง
2334,57126,51868,108994,51067,อภ.เมืองเชียงราย
2335,7426,6615,14041,11264,อภ.เมืองเชียงใหม่
2336,47885,42312,90197,34794,อภ.เมืองเพชรบุรี
2337,79880,80699,160579,62078,อภ.เมืองเพชรบูรณ์
2338,29078,29995,59073,23494,อภ.เมืองเลย
2339,32949,29572,62521,27253,อภ.เมืองแพร่
2340,27839,28328,56167,22862,อภ.เมืองแม่ฮ่องสอน
2341,20671,20826,41497,12812,อภ.เรณูนคร
2342,26800,26598,53398,18105,อภ.เลาขวัญ
2343,44771,44491,89262,28249,อภ.เลิงนกทา
2344,19929,18911,38840,15263,อภ.เวียงชัย
2345,30851,30385,61236,24366,อภ.เวียงป่าเป้า
2346,8677,8424,17101,6796,อภ.เวียงสระ
2347,33310,33673,66983,24382,อภ.เวียงสา
2348,10095,9909,20004,5597,อภ.เวียงเก่า
2349,12059,11862,23921,8945,อภ.เวียงเชียงรุ้ง
2350,17937,18416,36353,13030,อภ.เวียงแก่น
2351,26731,27193,53924,9414,อภ.เวียงแหง
2352,15994,15200,31194,9832,อภ.เสนา
2353,17658,17402,35060,10446,อภ.เสนางคนิคม
2354,11069,11146,22215,7622,อภ.เสริมงาม
2355,45431,44958,90389,24931,อภ.เสลภูมิ
2356,11591,10588,22179,8227,อภ.เสาไห้
2357,28676,28282,56958,17130,อภ.เสิงสาง
2358,30250,29687,59937,20157,อภ.เหนือคลอง
2359,13909,14055,27964,7797,อภ.เหล่าเสือโก้ก
2360,17048,17051,34099,11420,อภ.เอราวัณ
2361,12124,12271,24395,6526,อภ.แกดำ
2362,34943,32540,67483,30962,อภ.แกลง
2363,16041,17204,33245,15166,อภ.แก่งกระจาน
2364,35415,34590,70005,30672,อภ.แก่งคอย
2365,21052,21275,42327,20687,อภ.แก่งหางแมว
2366,36448,36357,72805,24951,อภ.แก้งคร้อ
2367,18505,18330,36835,10673,อภ.แก้งสนามนาง
2368,13529,13356,26885,7327,อภ.แคนดง
2369,17802,17349,35151,13142,อภ.แจ้ห่ม
2370,10396,10686,21082,10862,อภ.แปลงยาว
2371,7970,8287,16257,4892,อภ.แม่จริม
2372,36351,34002,70353,28143,อภ.แม่จัน
2373,14235,14041,28276,10681,อภ.แม่ทะ
2374,12679,12388,25067,10678,อภ.แม่ทา
2375,4792,4618,9410,3189,อภ.แม่พริก
2376,38779,38576,77355,24822,อภ.แม่ฟ้าหลวง
2377,24213,25530,49743,16697,อภ.แม่ระมาด
2378,43154,41656,84810,37559,อภ.แม่ริม
2379,8861,8542,17403,4473,อภ.แม่ลาน
2380,16046,16288,32334,10719,อภ.แม่ลาน้อย
2381,12663,12044,24707,10856,อภ.แม่ลาว
2382,25222,24982,50204,18663,อภ.แม่วงก์
2383,13738,13602,27340,9783,อภ.แม่วาง
2384,38783,39324,78107,29052,อภ.แม่สรวย
2385,47783,48761,96544,36020,อภ.แม่สอด
2386,25958,26423,52381,21357,อภ.แม่สะเรียง
2387,36839,32931,69770,28865,อภ.แม่สาย
2388,10635,10455,21090,9411,อภ.แม่ออน
2389,33732,33747,67479,27851,อภ.แม่อาย
2390,10395,10512,20907,6903,อภ.แม่เปิน
2391,12016,12171,24187,8965,อภ.แม่เมาะ
2392,28219,29072,57291,17996,อภ.แม่แจ่ม
2393,30135,29875,60010,24369,อภ.แม่แตง
2394,10478,9849,20327,9431,อภ.แม่ใจ
2395,19463,19341,38804,11268,อภ.แวงน้อย
2396,12212,12002,24214,6363,อภ.แวงใหญ่
2397,22116,21514,43630,10323,อภ.แว้ง
2398,15839,15077,30916,9961,อภ.แสวงหา
2399,7081,6918,13999,5784,อภ.แหลมงอบ
2400,7304,6929,14233,5300,อภ.แหลมสิงห์
2401,13739,13070,26809,9614,อภ.โกรกพระ
2402,14101,14126,28227,10629,อภ.โกสัมพีนคร
2403,55642,54222,109864,31504,อภ.โกสุมพิสัย
2404,17532,17976,35508,10010,อภ.โขงเจียม
2405,10964,10846,21810,7534,อภ.โคกศรีสุพรรณ
2406,38536,37896,76432,28633,อภ.โคกสำโรง
2407,13727,13509,27236,8277,อภ.โคกสูง
2408,12198,12186,24384,8472,อภ.โคกเจริญ
2409,31812,30383,62195,17737,อภ.โคกโพธิ์
2410,10558,10584,21142,6523,อภ.โคกโพธิ์ไชย
2411,25552,24083,49635,18937,อภ.โชคชัย
2412,32296,32715,65011,19008,อภ.โซ่พิสัย
2413,19595,19838,39433,10878,อภ.โนนคูณ
2414,9259,9458,18717,5713,อภ.โนนดินแดง
2415,17580,17408,34988,8548,อภ.โนนนารายณ์
2416,10534,10486,21020,6383,อภ.โนนศิลา
2417,22715,22648,45363,11984,อภ.โนนสะอาด
2418,27184,26889,54073,13567,อภ.โนนสัง
2419,10936,10931,21867,6329,อภ.โนนสุวรรณ
2420,43431,41749,85180,24870,อภ.โนนสูง
2421,10676,10243,20919,5555,อภ.โนนแดง
2422,27909,26888,54797,16641,อภ.โนนไทย
2423,10296,10880,21176,8487,อภ.โป่งน้ำร้อน
2424,27934,26726,54660,18686,อภ.โพทะเล
2425,37001,34849,71850,25130,อภ.โพธาราม
2426,13557,13438,26995,7375,อภ.โพธิ์ชัย
2427,7625,7659,15284,5136,อภ.โพธิ์ตาก
2428,22935,20865,43800,15385,อภ.โพธิ์ทอง
2429,17188,16724,33912,11452,อภ.โพธิ์ประทับช้าง
2430,11829,11897,23726,5621,อภ.โพธิ์ศรีสุวรรณ
2431,21820,22552,44372,11799,อภ.โพธิ์ไทร
2432,11192,11218,22410,5099,อภ.โพนทราย
2433,48707,48096,96803,28159,อภ.โพนทอง
2434,18402,18453,36855,13491,อภ.โพนนาแก้ว
2435,47992,47640,95632,31376,อภ.โพนพิสัย
2436,26302,26248,52550,16797,อภ.โพนสวรรค์
2437,17280,17255,34535,11531,อภ.ไชยปราการ
2438,11750,12015,23765,5985,อภ.ไชยวาน
2439,19718,18905,38623,16594,อภ.ไชยา
2440,3697,3424,7121,2387,อภ.ไชโย
2441,15252,15181,30433,10206,อภ.ไทยเจริญ
2442,22806,22585,45391,14860,อภ.ไทรงาม
2443,35734,32561,68295,32063,อภ.ไทรน้อย
2444,28535,30561,59096,20932,อภ.ไทรโยค
2445,18477,18179,36656,9050,อภ.ไพรบึง
2446,30263,29681,59944,20948,อภ.ไพศาลี
2447,6552,6388,12940,3381,อภ.ไม้แก่น
2448,706963,644516,1351479,711804,สมุทรปราการ
2449,682437,594308,1276745,718799,นนทบุรี
2450,425537,393551,819088,336357,พระนครศรีอยุธยา
2451,144191,132393,276584,101291,อ่างทอง
2452,371771,371157,742928,299338,ลพบุรี
2453,108001,97897,205898,78410,สิงห์บุรี
2454,167464,155013,322477,126673,ชัยนาท
2455,327323,316505,643828,283069,สระบุรี
2456,377324,364200,741524,506761,ระยอง
2457,273532,262027,535559,243727,จันทบุรี
2458,115405,113131,228536,108270,ตราด
2459,367276,353442,720718,313586,ฉะเชิงเทรา
2460,249652,244018,493670,220064,ปราจีนบุรี
2461,131454,128627,260081,101547,นครนายก
2462,280908,280017,560925,217621,สระแก้ว
2463,1338585,1294622,2633207,1004213,นครราชสีมา
2464,795962,785222,1581184,476118,บุรีรัมย์
2465,692421,685800,1378221,403890,สุรินทร์
2466,732274,726306,1458580,399090,ศรีสะเกษ
2467,934297,932400,1866697,616810,อุบลราชธานี
2468,267484,267016,534500,175666,ยโสธร
2469,568879,556045,1124924,400583,ชัยภูมิ
2470,188886,187309,376195,120188,อำนาจเจริญ
2471,210369,211673,422042,137871,บึงกาฬ
2472,255239,254231,509470,152361,หนองบัวลำภู
2473,790876,777107,1567983,528347,อุดรธานี
2474,318571,320165,638736,226892,เลย
2475,260612,256823,517435,178748,หนองคาย
2476,486163,467497,953660,304433,มหาสารคาม
2477,654422,644218,1298640,394597,ร้อยเอ็ด
2478,493728,483447,977175,311145,กาฬสินธุ์
2479,576651,570285,1146936,387699,สกลนคร
2480,359607,357594,717201,231315,นครพนม
2481,175544,175367,350911,117741,มุกดาหาร
2482,208630,193381,402011,182323,ลำพูน
2483,373706,355258,728964,295396,ลำปาง
2484,229757,218988,448745,172565,อุตรดิตถ์
2485,226377,210973,437350,179040,แพร่
2486,237989,238738,476727,170708,น่าน
2487,239670,227686,467356,195004,พะเยา
2488,665066,629960,1295026,558825,เชียงราย
2489,140238,144311,284549,115163,แม่ฮ่องสอน
2490,532929,507379,1040308,420803,นครสวรรค์
2491,166546,159322,325868,125666,อุทัยธานี
2492,361407,352711,714118,278306,กำแพงเพชร
2493,331314,338951,670265,224890,ตาก
2494,302934,284949,587883,220160,สุโขทัย
2495,433247,416234,849481,352300,พิษณุโลก
2496,272659,259651,532310,198230,พิจิตร
2497,497054,484886,981940,364119,เพชรบูรณ์
2498,446482,422831,869313,325837,ราชบุรี
2499,443993,447983,891976,348371,กาญจนบุรี
2500,433970,404658,838628,306999,สุพรรณบุรี
2501,478845,441884,920729,411586,นครปฐม
2502,303476,282723,586199,296825,สมุทรสาคร
2503,100227,91825,192052,72732,สมุทรสงคราม
2504,249278,232915,482193,220362,เพชรบุรี
2505,240528,237242,477770,193701,กระบี่
2506,134486,133743,268229,118609,พังงา
2507,218676,195795,414471,272917,ภูเก็ต
2508,542010,525716,1067726,512366,สุราษฎร์ธานี
2509,96218,98154,194372,92739,ระนอง
2510,257838,251370,509208,240248,ชุมพร
2511,732260,696349,1428609,553597,สงขลา
2512,162795,161303,324098,105903,สตูล
2513,327206,313368,640574,234863,ตรัง
2514,268169,254908,523077,197086,พัทลุง
2515,367404,358611,726015,195224,ปัตตานี
2516,270683,267919,538602,170091,ยะลา
2517,406729,397700,804429,219403,นราธิวาส
2518,2962284,2625938,5588222,3103483,กรุงเทพมหานคร
2519,912069,882462,1794531,640781,ขอนแก่น
2520,802902,763983,1566885,1070209,ชลบุรี
2521,785351,765370,1550721,581948,นครศรีธรรมราช
2522,618660,557752,1176412,642474,ปทุมธานี
2523,277829,272849,550678,271890,ประจวบคีรีขันธ์
2524,921496,862874,1784370,835977,เชียงใหม่
2525,10529379,9703879,20233258,9550971,CT
2526,2466999,2380818,4847817,2680238,E_
2527,10320218,10149789,20470007,6804598,NE
2528,3242929,3082169,6325098,2705001,N_
2529,5502774,5343348,10846122,4092585,S_
2530,1748896,1715529,3464425,1391350,W_
2531,33811195,32375532,66186727,27224743,TH
