index,labels,ids,parents,pop_MF,pop_F,pop_M,hholds
0,ทข.คลองสาน,TH/CT/กรุงเทพมหานคร/ทข.คลองสาน,TH/CT/กรุงเทพมหานคร,69139,37170,31969,39924
1,ทข.คลองสามวา,TH/CT/กรุงเทพมหานคร/ทข.คลองสามวา,TH/CT/กรุงเทพมหานคร,204900,108231,96669,86477
2,ทข.คลองเตย,TH/CT/กรุงเทพมหานคร/ทข.คลองเตย,TH/CT/กรุงเทพมหานคร,93193,49037,44156,77502
3,ทข.คันนายาว,TH/CT/กรุงเทพมหานคร/ทข.คันนายาว,TH/CT/กรุงเทพมหานคร,96330,51390,44940,45864
4,ทข.จตุจักร,TH/CT/กรุงเทพมหานคร/ทข.จตุจักร,TH/CT/กรุงเทพมหานคร,155297,83503,71794,126570
5,ทข.จอมทอง,TH/CT/กรุงเทพมหานคร/ทข.จอมทอง,TH/CT/กรุงเทพมหานคร,148290,78025,70265,73778
6,ทข.ดอนเมือง,TH/CT/กรุงเทพมหานคร/ทข.ดอนเมือง,TH/CT/กรุงเทพมหานคร,170791,84968,85823,77410
7,ทข.ดินแดง,TH/CT/กรุงเทพมหานคร/ทข.ดินแดง,TH/CT/กรุงเทพมหานคร,115508,62320,53188,63821
8,ทข.ดุสิต,TH/CT/กรุงเทพมหานคร/ทข.ดุสิต,TH/CT/กรุงเทพมหานคร,83897,38859,45038,31653
9,ทข.ตลิ่งชัน,TH/CT/กรุงเทพมหานคร/ทข.ตลิ่งชัน,TH/CT/กรุงเทพมหานคร,103617,55226,48391,42898
10,ทข.ทวีวัฒนา,TH/CT/กรุงเทพมหานคร/ทข.ทวีวัฒนา,TH/CT/กรุงเทพมหานคร,78749,42256,36493,34420
11,ทข.ทุ่งครุ,TH/CT/กรุงเทพมหานคร/ทข.ทุ่งครุ,TH/CT/กรุงเทพมหานคร,123700,65673,58027,54595
12,ทข.ธนบุรี,TH/CT/กรุงเทพมหานคร/ทข.ธนบุรี,TH/CT/กรุงเทพมหานคร,103377,54983,48394,57707
13,ทข.บางกอกน้อย,TH/CT/กรุงเทพมหานคร/ทข.บางกอกน้อย,TH/CT/กรุงเทพมหานคร,103791,54691,49100,50652
14,ทข.บางกอกใหญ่,TH/CT/กรุงเทพมหานคร/ทข.บางกอกใหญ่,TH/CT/กรุงเทพมหานคร,63861,33874,29987,32258
15,ทข.บางกะปิ,TH/CT/กรุงเทพมหานคร/ทข.บางกะปิ,TH/CT/กรุงเทพมหานคร,144732,78900,65832,107103
16,ทข.บางขุนเทียน,TH/CT/กรุงเทพมหานคร/ทข.บางขุนเทียน,TH/CT/กรุงเทพมหานคร,186144,98400,87744,91013
17,ทข.บางคอแหลม,TH/CT/กรุงเทพมหานคร/ทข.บางคอแหลม,TH/CT/กรุงเทพมหานคร,82733,43649,39084,39812
18,ทข.บางซื่อ,TH/CT/กรุงเทพมหานคร/ทข.บางซื่อ,TH/CT/กรุงเทพมหานคร,122410,65471,56939,76116
19,ทข.บางนา,TH/CT/กรุงเทพมหานคร/ทข.บางนา,TH/CT/กรุงเทพมหานคร,88535,47555,40980,72092
20,ทข.บางบอน,TH/CT/กรุงเทพมหานคร/ทข.บางบอน,TH/CT/กรุงเทพมหานคร,104366,54469,49897,50825
21,ทข.บางพลัด,TH/CT/กรุงเทพมหานคร/ทข.บางพลัด,TH/CT/กรุงเทพมหานคร,89417,48708,40709,55838
22,ทข.บางรัก,TH/CT/กรุงเทพมหานคร/ทข.บางรัก,TH/CT/กรุงเทพมหานคร,45757,24230,21527,32371
23,ทข.บางเขน,TH/CT/กรุงเทพมหานคร/ทข.บางเขน,TH/CT/กรุงเทพมหานคร,187377,99379,87998,114661
24,ทข.บางแค,TH/CT/กรุงเทพมหานคร/ทข.บางแค,TH/CT/กรุงเทพมหานคร,193303,103527,89776,94020
25,ทข.บึงกุ่ม,TH/CT/กรุงเทพมหานคร/ทข.บึงกุ่ม,TH/CT/กรุงเทพมหานคร,140817,76618,64199,75943
26,ทข.ปทุมวัน,TH/CT/กรุงเทพมหานคร/ทข.ปทุมวัน,TH/CT/กรุงเทพมหานคร,43338,23028,20310,32590
27,ทข.ประเวศ,TH/CT/กรุงเทพมหานคร/ทข.ประเวศ,TH/CT/กรุงเทพมหานคร,181821,96478,85343,92009
28,ทข.ป้อมปราบศัตรูพ่าย,TH/CT/กรุงเทพมหานคร/ทข.ป้อมปราบศัตรูพ่าย,TH/CT/กรุงเทพมหานคร,41524,21327,20197,19627
29,ทข.พญาไท,TH/CT/กรุงเทพมหานคร/ทข.พญาไท,TH/CT/กรุงเทพมหานคร,67388,34272,33116,44727
30,ทข.พระนคร,TH/CT/กรุงเทพมหานคร/ทข.พระนคร,TH/CT/กรุงเทพมหานคร,44923,23248,21675,19137
31,ทข.พระโขนง,TH/CT/กรุงเทพมหานคร/ทข.พระโขนง,TH/CT/กรุงเทพมหานคร,87856,48243,39613,60007
32,ทข.ภาษีเจริญ,TH/CT/กรุงเทพมหานคร/ทข.ภาษีเจริญ,TH/CT/กรุงเทพมหานคร,124318,66372,57946,65843
33,ทข.มีนบุรี,TH/CT/กรุงเทพมหานคร/ทข.มีนบุรี,TH/CT/กรุงเทพมหานคร,142197,75097,67100,61665
34,ทข.ยานนาวา,TH/CT/กรุงเทพมหานคร/ทข.ยานนาวา,TH/CT/กรุงเทพมหานคร,76564,40920,35644,53614
35,ทข.ราชเทวี,TH/CT/กรุงเทพมหานคร/ทข.ราชเทวี,TH/CT/กรุงเทพมหานคร,69264,36127,33137,52494
36,ทข.ราษฎร์บูรณะ,TH/CT/กรุงเทพมหานคร/ทข.ราษฎร์บูรณะ,TH/CT/กรุงเทพมหานคร,78687,41200,37487,37664
37,ทข.ลาดกระบัง,TH/CT/กรุงเทพมหานคร/ทข.ลาดกระบัง,TH/CT/กรุงเทพมหานคร,178971,93840,85131,98260
38,ทข.ลาดพร้าว,TH/CT/กรุงเทพมหานคร/ทข.ลาดพร้าว,TH/CT/กรุงเทพมหานคร,117108,63876,53232,57916
39,ทข.วังทองหลาง,TH/CT/กรุงเทพมหานคร/ทข.วังทองหลาง,TH/CT/กรุงเทพมหานคร,107458,58405,49053,62673
40,ทข.วัฒนา,TH/CT/กรุงเทพมหานคร/ทข.วัฒนา,TH/CT/กรุงเทพมหานคร,81623,43651,37972,82407
41,ทข.สวนหลวง,TH/CT/กรุงเทพมหานคร/ทข.สวนหลวง,TH/CT/กรุงเทพมหานคร,123609,67110,56499,81116
42,ทข.สะพานสูง,TH/CT/กรุงเทพมหานคร/ทข.สะพานสูง,TH/CT/กรุงเทพมหานคร,96092,52034,44058,41308
43,ทข.สัมพันธวงศ์,TH/CT/กรุงเทพมหานคร/ทข.สัมพันธวงศ์,TH/CT/กรุงเทพมหานคร,21324,10957,10367,13197
44,ทข.สาทร,TH/CT/กรุงเทพมหานคร/ทข.สาทร,TH/CT/กรุงเทพมหานคร,75735,39907,35828,43459
45,ทข.สายไหม,TH/CT/กรุงเทพมหานคร/ทข.สายไหม,TH/CT/กรุงเทพมหานคร,207272,110020,97252,106139
46,ทข.หนองจอก,TH/CT/กรุงเทพมหานคร/ทข.หนองจอก,TH/CT/กรุงเทพมหานคร,177979,91415,86564,66754
47,ทข.หนองแขม,TH/CT/กรุงเทพมหานคร/ทข.หนองแขม,TH/CT/กรุงเทพมหานคร,156203,83319,72884,62675
48,ทข.หลักสี่,TH/CT/กรุงเทพมหานคร/ทข.หลักสี่,TH/CT/กรุงเทพมหานคร,102704,53807,48897,57833
49,ทข.ห้วยขวาง,TH/CT/กรุงเทพมหานคร/ทข.ห้วยขวาง,TH/CT/กรุงเทพมหานคร,84233,46519,37714,85046
50,ทต.กกโก,TH/CT/16/ทต.กกโก,TH/CT/16,10303,5549,4754,5177
51,ทต.กงไกรลาศ,TH/CT/64/ทต.กงไกรลาศ,TH/CT/64,4119,2167,1952,2016
52,ทต.กบินทร์,TH/E_/25/ทต.กบินทร์,TH/E_/25,3837,2065,1772,2193
53,ทต.กม.5,TH/W_/ประจวบคีรีขันธ์/ทต.กม.5,TH/W_/ประจวบคีรีขันธ์,3599,1869,1730,1389
54,ทต.กมลาไสย,TH/NE/46/ทต.กมลาไสย,TH/NE/46,9816,5165,4651,3618
55,ทต.กรอกสมบูรณ์,TH/E_/25/ทต.กรอกสมบูรณ์,TH/E_/25,3481,1753,1728,1272
56,ทต.กระจัน,TH/CT/72/ทต.กระจัน,TH/CT/72,7331,3763,3568,1949
57,ทต.กระจับ,TH/W_/70/ทต.กระจับ,TH/W_/70,7806,4104,3702,3708
58,ทต.กระดังงา,TH/CT/75/ทต.กระดังงา,TH/CT/75,2219,1183,1036,851
59,ทต.กระบี่น้อย,TH/S_/81/ทต.กระบี่น้อย,TH/S_/81,18239,9251,8988,8566
60,ทต.กระสัง,TH/NE/31/ทต.กระสัง,TH/NE/31,3398,1787,1611,1797
61,ทต.กระหวัน,TH/NE/33/ทต.กระหวัน,TH/NE/33,8819,4467,4352,2196
62,ทต.กระโสม,TH/S_/82/ทต.กระโสม,TH/S_/82,1810,949,861,773
63,ทต.กรับใหญ่,TH/W_/70/ทต.กรับใหญ่,TH/W_/70,12962,6719,6243,3815
64,ทต.กลางดง,TH/NE/30/ทต.กลางดง,TH/NE/30,5021,2559,2462,2665
65,ทต.กองดิน,TH/E_/21/ทต.กองดิน,TH/E_/21,4838,2447,2391,1831
66,ทต.กะรน,TH/S_/83/ทต.กะรน,TH/S_/83,7733,4072,3661,8500
67,ทต.กะเปอร์,TH/S_/85/ทต.กะเปอร์,TH/S_/85,1555,798,757,666
68,ทต.กังแอน,TH/S_/32/ทต.กังแอน,TH/S_/32,5727,3028,2699,3380
69,ทต.กันทรอม,TH/NE/33/ทต.กันทรอม,TH/NE/33,9011,4426,4585,2236
70,ทต.กันทรารมย์,TH/NE/33/ทต.กันทรารมย์,TH/NE/33,6082,3145,2937,3182
71,ทต.กาญจนดิษฐ์,TH/S_/84/ทต.กาญจนดิษฐ์,TH/S_/84,9539,4956,4583,4674
72,ทต.กำเนิดนพคุณ,TH/W_/ประจวบคีรีขันธ์/ทต.กำเนิดนพคุณ,TH/W_/ประจวบคีรีขันธ์,2624,1329,1295,1618
73,ทต.กำแพง,TH/NE/33/ทต.กำแพง,TH/NE/33,2705,1399,1306,1327
74,ทต.กำแพง,TH/S_/91/ทต.กำแพง,TH/S_/91,5009,2629,2380,2834
75,ทต.กำแพงดิน,TH/CT/66/ทต.กำแพงดิน,TH/CT/66,2194,1142,1052,823
76,ทต.กำแพงเพชร,TH/S_/90/ทต.กำแพงเพชร,TH/S_/90,4913,2540,2373,2550
77,ทต.กำแพงแสน,TH/CT/73/ทต.กำแพงแสน,TH/CT/73,6840,3600,3240,4177
78,ทต.กุดข้าวปุ้น,TH/NE/34/ทต.กุดข้าวปุ้น,TH/NE/34,4136,2036,2100,1454
79,ทต.กุดจับ,TH/NE/41/ทต.กุดจับ,TH/NE/41,10254,5300,4954,3849
80,ทต.กุดจิก,TH/NE/30/ทต.กุดจิก,TH/NE/30,2647,1394,1253,1257
81,ทต.กุดชมภู,TH/NE/34/ทต.กุดชมภู,TH/NE/34,11742,5839,5903,4337
82,ทต.กุดชุมพัฒนา,TH/NE/35/ทต.กุดชุมพัฒนา,TH/NE/35,4846,2476,2370,2162
83,ทต.กุดดินจี่,TH/NE/39/ทต.กุดดินจี่,TH/NE/39,5641,2866,2775,1812
84,ทต.กุดดู่,TH/NE/39/ทต.กุดดู่,TH/NE/39,2767,1381,1386,739
85,ทต.กุดนกเปล้า,TH/CT/19/ทต.กุดนกเปล้า,TH/CT/19,5887,3028,2859,2566
86,ทต.กุดน้ำใส,TH/NE/ขอนแก่น/ทต.กุดน้ำใส,TH/NE/ขอนแก่น,8483,4316,4167,2551
87,ทต.กุดบาก,TH/NE/47/ทต.กุดบาก,TH/NE/47,5123,2643,2480,1845
88,ทต.กุดประทาย,TH/NE/34/ทต.กุดประทาย,TH/NE/34,13622,6714,6908,5015
89,ทต.กุดสิม,TH/NE/46/ทต.กุดสิม,TH/NE/46,10274,5283,4991,4467
90,ทต.กุดหว้า,TH/NE/46/ทต.กุดหว้า,TH/NE/46,5249,2723,2526,2052
91,ทต.กุมภวาปี,TH/NE/41/ทต.กุมภวาปี,TH/NE/41,8215,4260,3955,4457
92,ทต.กุยบุรี,TH/W_/ประจวบคีรีขันธ์/ทต.กุยบุรี,TH/W_/ประจวบคีรีขันธ์,8793,4588,4205,4194
93,ทต.กุสุมาลย์,TH/NE/47/ทต.กุสุมาลย์,TH/NE/47,4065,2097,1968,1689
94,ทต.กู่กาสิงห์,TH/NE/45/ทต.กู่กาสิงห์,TH/NE/45,4636,2365,2271,1578
95,ทต.ขนอม,TH/S_/นครศรีธรรมราช/ทต.ขนอม,TH/S_/นครศรีธรรมราช,4424,2219,2205,2412
96,ทต.ขวาว,TH/NE/45/ทต.ขวาว,TH/NE/45,9000,4566,4434,2200
97,ทต.ขาณุวรลักษบุรี,TH/CT/62/ทต.ขาณุวรลักษบุรี,TH/CT/62,8110,4186,3924,3403
98,ทต.ขามทะเลสอ,TH/NE/30/ทต.ขามทะเลสอ,TH/NE/30,4240,2143,2097,2128
99,ทต.ขามป้อม,TH/NE/34/ทต.ขามป้อม,TH/NE/34,9563,4735,4828,3156
100,ทต.ขามสะแกแสง,TH/NE/30/ทต.ขามสะแกแสง,TH/NE/30,5134,2689,2445,1892
101,ทต.ขามเรียง,TH/NE/44/ทต.ขามเรียง,TH/NE/44,16511,9848,6663,5518
102,ทต.ขามใหญ่,TH/NE/34/ทต.ขามใหญ่,TH/NE/34,39046,20404,18642,19877
103,ทต.ขุนทะเล,TH/S_/84/ทต.ขุนทะเล,TH/S_/84,16325,9099,7226,11181
104,ทต.ขุนพัดเพ็ง,TH/CT/72/ทต.ขุนพัดเพ็ง,TH/CT/72,5406,2719,2687,1829
105,ทต.ขุนยวม,TH/N_/58/ทต.ขุนยวม,TH/N_/58,3477,1774,1703,1709
106,ทต.ขุนหาญ,TH/NE/33/ทต.ขุนหาญ,TH/NE/33,10856,5494,5362,3718
107,ทต.คชสิทธิ์,TH/CT/19/ทต.คชสิทธิ์,TH/CT/19,1353,696,657,652
108,ทต.ครึ่ง,TH/N_/57/ทต.ครึ่ง,TH/N_/57,6374,3178,3196,2674
109,ทต.คลองขลุง,TH/CT/62/ทต.คลองขลุง,TH/CT/62,1980,1027,953,1019
110,ทต.คลองขุด,TH/S_/91/ทต.คลองขุด,TH/S_/91,20369,9815,10554,9086
111,ทต.คลองจิก,TH/CT/14/ทต.คลองจิก,TH/CT/14,9339,4936,4403,5310
112,ทต.คลองชะอุ่น,TH/S_/84/ทต.คลองชะอุ่น,TH/S_/84,9500,4723,4777,3342
113,ทต.คลองด่าน,TH/CT/11/ทต.คลองด่าน,TH/CT/11,11390,5781,5609,3174
114,ทต.คลองตำหรุ,TH/E_/ชลบุรี/ทต.คลองตำหรุ,TH/E_/ชลบุรี,4722,2496,2226,6486
115,ทต.คลองท่อมใต้,TH/S_/81/ทต.คลองท่อมใต้,TH/S_/81,3518,1828,1690,1779
116,ทต.คลองปาง,TH/S_/92/ทต.คลองปาง,TH/S_/92,2255,1160,1095,1325
117,ทต.คลองพน,TH/S_/81/ทต.คลองพน,TH/S_/81,2889,1491,1398,1288
118,ทต.คลองพิไกร,TH/CT/62/ทต.คลองพิไกร,TH/CT/62,5929,3045,2884,2229
119,ทต.คลองลานพัฒนา,TH/CT/62/ทต.คลองลานพัฒนา,TH/CT/62,22639,11509,11130,8484
120,ทต.คลองวาฬ,TH/W_/ประจวบคีรีขันธ์/ทต.คลองวาฬ,TH/W_/ประจวบคีรีขันธ์,4440,2292,2148,1839
121,ทต.คลองสวน,TH/CT/11/ทต.คลองสวน,TH/CT/11,3000,1539,1461,851
122,ทต.คลองเต็ง,TH/S_/92/ทต.คลองเต็ง,TH/S_/92,3744,1951,1793,1709
123,ทต.คลองแงะ,TH/S_/90/ทต.คลองแงะ,TH/S_/90,8270,4199,4071,3415
124,ทต.คลองแม่ลาย,TH/CT/62/ทต.คลองแม่ลาย,TH/CT/62,5858,3011,2847,2428
125,ทต.คลองโยง,TH/CT/73/ทต.คลองโยง,TH/CT/73,10601,5556,5045,4390
126,ทต.คลองใหญ่,TH/E_/22/ทต.คลองใหญ่,TH/E_/22,5315,2663,2652,2069
127,ทต.คลองใหญ่,TH/E_/23/ทต.คลองใหญ่,TH/E_/23,5333,2710,2623,2440
128,ทต.คลองไผ่,TH/NE/30/ทต.คลองไผ่,TH/NE/30,3729,1712,2017,1738
129,ทต.ควนกุน,TH/S_/92/ทต.ควนกุน,TH/S_/92,2178,1118,1060,747
130,ทต.ควนขนุน,TH/S_/93/ทต.ควนขนุน,TH/S_/93,2156,1138,1018,1176
131,ทต.ควนเนียง,TH/S_/90/ทต.ควนเนียง,TH/S_/90,4170,2228,1942,1753
132,ทต.ควนโดน,TH/S_/91/ทต.ควนโดน,TH/S_/91,5426,2719,2707,1925
133,ทต.คอกช้าง,TH/S_/95/ทต.คอกช้าง,TH/S_/95,1499,731,768,584
134,ทต.คอนสวรรค์,TH/NE/36/ทต.คอนสวรรค์,TH/NE/36,4257,2252,2005,1885
135,ทต.คอนสาร,TH/NE/36/ทต.คอนสาร,TH/NE/36,4242,2218,2024,1428
136,ทต.คอแลน,TH/NE/34/ทต.คอแลน,TH/NE/34,13215,6534,6681,4084
137,ทต.คำชะอี,TH/NE/49/ทต.คำชะอี,TH/NE/49,2385,1203,1182,1126
138,ทต.คำตากล้า,TH/NE/47/ทต.คำตากล้า,TH/NE/47,7314,3716,3598,2274
139,ทต.คำน้ำแซบ,TH/NE/34/ทต.คำน้ำแซบ,TH/NE/34,8019,4037,3982,3144
140,ทต.คำบง,TH/NE/46/ทต.คำบง,TH/NE/46,10458,5193,5265,2975
141,ทต.คำบ่อ,TH/NE/47/ทต.คำบ่อ,TH/NE/47,13836,7017,6819,4108
142,ทต.คำพราน,TH/CT/19/ทต.คำพราน,TH/CT/19,4204,2117,2087,2053
143,ทต.คำพอุง,TH/NE/45/ทต.คำพอุง,TH/NE/45,9288,4601,4687,2596
144,ทต.คำม่วง,TH/NE/46/ทต.คำม่วง,TH/NE/46,3936,1998,1938,1684
145,ทต.คำอาฮวน,TH/NE/49/ทต.คำอาฮวน,TH/NE/49,12801,6363,6438,4615
146,ทต.คำเขื่อนแก้ว,TH/NE/35/ทต.คำเขื่อนแก้ว,TH/NE/35,3857,1956,1901,1547
147,ทต.คำใหญ่,TH/NE/46/ทต.คำใหญ่,TH/NE/46,5005,2535,2470,1601
148,ทต.คุระบุรี,TH/S_/82/ทต.คุระบุรี,TH/S_/82,3467,1756,1711,2121
149,ทต.คุ้งตะเภา,TH/N_/53/ทต.คุ้งตะเภา,TH/N_/53,8839,4566,4273,3468
150,ทต.คุ้งสำเภา,TH/CT/18/ทต.คุ้งสำเภา,TH/CT/18,1865,954,911,988
151,ทต.คูเต่า,TH/S_/90/ทต.คูเต่า,TH/S_/90,11447,5773,5674,3155
152,ทต.คูเมือง,TH/NE/31/ทต.คูเมือง,TH/NE/31,3592,1788,1804,1939
153,ทต.ค้อวัง,TH/NE/35/ทต.ค้อวัง,TH/NE/35,4505,2299,2206,1608
154,ทต.งิม,TH/N_/56/ทต.งิม,TH/N_/56,6748,3411,3337,2474
155,ทต.จตุรพักตรพิมาน,TH/NE/45/ทต.จตุรพักตรพิมาน,TH/NE/45,3875,2083,1792,1571
156,ทต.จระเข้หิน,TH/NE/30/ทต.จระเข้หิน,TH/NE/30,6151,3246,2905,2379
157,ทต.จริม,TH/N_/53/ทต.จริม,TH/N_/53,8520,4152,4368,2354
158,ทต.จอมทอง,TH/NE/39/ทต.จอมทอง,TH/NE/39,5018,2470,2548,1509
159,ทต.จอมทอง,TH/N_/เชียงใหม่/ทต.จอมทอง,TH/N_/เชียงใหม่,9272,4978,4294,4522
160,ทต.จอมบึง,TH/W_/70/ทต.จอมบึง,TH/W_/70,4890,2613,2277,3588
161,ทต.จอมพระ,TH/S_/32/ทต.จอมพระ,TH/S_/32,4150,2180,1970,1916
162,ทต.จอมพลเจ้าพระยา,TH/E_/21/ทต.จอมพลเจ้าพระยา,TH/E_/21,695,350,345,433
163,ทต.จอหอ,TH/NE/30/ทต.จอหอ,TH/NE/30,16700,8428,8272,9676
164,ทต.จะนะ,TH/S_/90/ทต.จะนะ,TH/S_/90,6884,3500,3384,3292
165,ทต.จักราช,TH/NE/30/ทต.จักราช,TH/NE/30,4077,2175,1902,1590
166,ทต.จัตุรัส,TH/NE/36/ทต.จัตุรัส,TH/NE/36,4162,2201,1961,2187
167,ทต.จันจว้า,TH/N_/57/ทต.จันจว้า,TH/N_/57,14298,7553,6745,6155
168,ทต.จันดี,TH/S_/นครศรีธรรมราช/ทต.จันดี,TH/S_/นครศรีธรรมราช,7310,3843,3467,3967
169,ทต.จันดุม,TH/NE/31/ทต.จันดุม,TH/NE/31,10538,5314,5224,2916
170,ทต.จันทบเพชร,TH/NE/31/ทต.จันทบเพชร,TH/NE/31,7842,3928,3914,2377
171,ทต.จำปี,TH/NE/41/ทต.จำปี,TH/NE/41,8210,4050,4160,2172
172,ทต.จุน,TH/N_/56/ทต.จุน,TH/N_/56,9135,4710,4425,3919
173,ทต.จุมจัง,TH/NE/46/ทต.จุมจัง,TH/NE/46,9602,4832,4770,2463
174,ทต.ฉลุง,TH/S_/91/ทต.ฉลุง,TH/S_/91,2358,1222,1136,996
175,ทต.ฉวาง,TH/S_/นครศรีธรรมราช/ทต.ฉวาง,TH/S_/นครศรีธรรมราช,2483,1263,1220,1279
176,ทต.ชนบท,TH/NE/ขอนแก่น/ทต.ชนบท,TH/NE/ขอนแก่น,8043,4249,3794,3299
177,ทต.ชนแดน,TH/CT/67/ทต.ชนแดน,TH/CT/67,3413,1660,1753,1824
178,ทต.ชมภู,TH/N_/เชียงใหม่/ทต.ชมภู,TH/N_/เชียงใหม่,7529,3927,3602,3067
179,ทต.ชะรัด,TH/S_/93/ทต.ชะรัด,TH/S_/93,7310,3690,3620,2237
180,ทต.ชะอวด,TH/S_/นครศรีธรรมราช/ทต.ชะอวด,TH/S_/นครศรีธรรมราช,3510,1883,1627,1658
181,ทต.ชัยนาท,TH/CT/18/ทต.ชัยนาท,TH/CT/18,7990,4357,3633,2671
182,ทต.ชัยวารี,TH/NE/45/ทต.ชัยวารี,TH/NE/45,5300,2699,2601,1657
183,ทต.ชากไทย,TH/E_/22/ทต.ชากไทย,TH/E_/22,4331,2220,2111,1867
184,ทต.ชานุมาน,TH/NE/37/ทต.ชานุมาน,TH/NE/37,3200,1665,1535,1420
185,ทต.ชุมพล,TH/S_/93/ทต.ชุมพล,TH/S_/93,8935,4124,4811,3530
186,ทต.ชุมพลบุรี,TH/S_/32/ทต.ชุมพลบุรี,TH/S_/32,2340,1234,1106,1085
187,ทต.ชุมพวง,TH/NE/30/ทต.ชุมพวง,TH/NE/30,8895,4567,4328,3799
188,ทต.ชุมแสง,TH/E_/21/ทต.ชุมแสง,TH/E_/21,3748,1893,1855,2230
189,ทต.ช่องลม,TH/CT/62/ทต.ช่องลม,TH/CT/62,5733,2865,2868,1770
190,ทต.ช่องเม็ก,TH/NE/34/ทต.ช่องเม็ก,TH/NE/34,3694,1872,1822,1879
191,ทต.ช่องแค,TH/CT/60/ทต.ช่องแค,TH/CT/60,3045,1579,1466,1062
192,ทต.ช่อแฮ,TH/N_/54/ทต.ช่อแฮ,TH/N_/54,8924,4612,4312,3640
193,ทต.ช้างซ้าย,TH/S_/84/ทต.ช้างซ้าย,TH/S_/84,11088,5595,5493,3889
194,ทต.ช้างเผือก,TH/N_/เชียงใหม่/ทต.ช้างเผือก,TH/N_/เชียงใหม่,8986,4759,4227,8888
195,ทต.ซับสมอทอด,TH/CT/67/ทต.ซับสมอทอด,TH/CT/67,8647,4414,4233,5058
196,ทต.ซำสูง,TH/NE/ขอนแก่น/ทต.ซำสูง,TH/NE/ขอนแก่น,5279,2700,2579,1907
197,ทต.ดงขุย,TH/CT/67/ทต.ดงขุย,TH/CT/67,2604,1366,1238,1021
198,ทต.ดงป่าคำ,TH/CT/66/ทต.ดงป่าคำ,TH/CT/66,4767,2425,2342,1607
199,ทต.ดงมะไฟ,TH/NE/47/ทต.ดงมะไฟ,TH/NE/47,5947,3130,2817,2258
200,ทต.ดงเจน,TH/N_/56/ทต.ดงเจน,TH/N_/56,8307,4395,3912,3554
201,ทต.ดงเย็น,TH/NE/49/ทต.ดงเย็น,TH/NE/49,10727,5279,5448,3039
202,ทต.ดงแดง,TH/NE/45/ทต.ดงแดง,TH/NE/45,8774,4489,4285,2407
203,ทต.ดอนฉิมพลี,TH/E_/24/ทต.ดอนฉิมพลี,TH/E_/24,1607,831,776,730
204,ทต.ดอนตาล,TH/NE/49/ทต.ดอนตาล,TH/NE/49,2568,1381,1187,952
205,ทต.ดอนทราย,TH/W_/70/ทต.ดอนทราย,TH/W_/70,7153,3747,3406,3093
206,ทต.ดอนพุด,TH/CT/19/ทต.ดอนพุด,TH/CT/19,4696,2378,2318,1817
207,ทต.ดอนยายหอม,TH/CT/73/ทต.ดอนยายหอม,TH/CT/73,6508,3377,3131,2186
208,ทต.ดอนหญ้านาง,TH/NE/38/ทต.ดอนหญ้านาง,TH/NE/38,5124,2583,2541,1484
209,ทต.ดอนหวาย,TH/NE/30/ทต.ดอนหวาย,TH/NE/30,3606,1892,1714,1278
210,ทต.ดอนหัวฬ่อ,TH/E_/ชลบุรี/ทต.ดอนหัวฬ่อ,TH/E_/ชลบุรี,13108,6615,6493,14699
211,ทต.ดอนเกาะกา,TH/E_/24/ทต.ดอนเกาะกา,TH/E_/24,8685,4285,4400,2356
212,ทต.ดอนเขือง,TH/NE/47/ทต.ดอนเขือง,TH/NE/47,4199,2113,2086,1241
213,ทต.ดอนเจดีย์,TH/CT/72/ทต.ดอนเจดีย์,TH/CT/72,2941,1508,1433,1365
214,ทต.ดอนโมง,TH/NE/ขอนแก่น/ทต.ดอนโมง,TH/NE/ขอนแก่น,3474,1769,1705,1804
215,ทต.ดอยสะเก็ด,TH/N_/เชียงใหม่/ทต.ดอยสะเก็ด,TH/N_/เชียงใหม่,4297,2282,2015,2128
216,ทต.ดำเนินสะดวก,TH/W_/70/ทต.ดำเนินสะดวก,TH/W_/70,7234,3858,3376,3216
217,ทต.ดินดำ,TH/NE/45/ทต.ดินดำ,TH/NE/45,6897,3495,3402,1992
218,ทต.ดีลัง,TH/CT/16/ทต.ดีลัง,TH/CT/16,8088,4183,3905,3739
219,ทต.ด่านขุนทด,TH/NE/30/ทต.ด่านขุนทด,TH/NE/30,6106,3233,2873,3936
220,ทต.ด่านคล้า,TH/NE/30/ทต.ด่านคล้า,TH/NE/30,8555,4358,4197,2567
221,ทต.ด่านช้าง,TH/CT/72/ทต.ด่านช้าง,TH/CT/72,6320,3293,3027,3341
222,ทต.ด่านซ้าย,TH/NE/42/ทต.ด่านซ้าย,TH/NE/42,3418,1740,1678,1932
223,ทต.ด่านทับตะโก,TH/W_/70/ทต.ด่านทับตะโก,TH/W_/70,2453,1212,1241,825
224,ทต.ด่านมะขามเตี้ย,TH/W_/71/ทต.ด่านมะขามเตี้ย,TH/W_/71,2495,1257,1238,1255
225,ทต.ด่านสำโรง,TH/CT/11/ทต.ด่านสำโรง,TH/CT/11,54918,29230,25688,25203
226,ทต.ด่านเกวียน,TH/NE/30/ทต.ด่านเกวียน,TH/NE/30,9780,5004,4776,4295
227,ทต.ตกพรม,TH/E_/22/ทต.ตกพรม,TH/E_/22,4154,2148,2006,1584
228,ทต.ตรอน,TH/N_/53/ทต.ตรอน,TH/N_/53,1680,869,811,675
229,ทต.ตระการพืชผล,TH/NE/34/ทต.ตระการพืชผล,TH/NE/34,9053,4627,4426,4307
230,ทต.ตลาดนิคมปราสาท,TH/NE/31/ทต.ตลาดนิคมปราสาท,TH/NE/31,4784,2456,2328,1726
231,ทต.ตลาดเขต,TH/W_/71/ทต.ตลาดเขต,TH/W_/71,4102,2173,1929,1789
232,ทต.ตลาดแค,TH/NE/30/ทต.ตลาดแค,TH/NE/30,3319,1738,1581,1313
233,ทต.ตลาดไชยา,TH/S_/84/ทต.ตลาดไชยา,TH/S_/84,5287,2802,2485,2930
234,ทต.ตลุกดู่,TH/CT/61/ทต.ตลุกดู่,TH/CT/61,11296,5802,5494,3634
235,ทต.ตองโขบ,TH/NE/47/ทต.ตองโขบ,TH/NE/47,12611,6388,6223,5651
236,ทต.ตะกาง,TH/E_/23/ทต.ตะกาง,TH/E_/23,2611,1338,1273,1334
237,ทต.ตะกุด,TH/CT/19/ทต.ตะกุด,TH/CT/19,4757,2405,2352,2189
238,ทต.ตะขบ,TH/NE/30/ทต.ตะขบ,TH/NE/30,5259,2688,2571,1874
239,ทต.ตะค่า,TH/CT/72/ทต.ตะค่า,TH/CT/72,5508,2863,2645,1909
240,ทต.ตะเคียนทอง,TH/E_/22/ทต.ตะเคียนทอง,TH/E_/22,4590,2269,2321,1814
241,ทต.ตะเคียนเตี้ย,TH/E_/ชลบุรี/ทต.ตะเคียนเตี้ย,TH/E_/ชลบุรี,24191,12544,11647,12241
242,ทต.ตะโหมด,TH/S_/93/ทต.ตะโหมด,TH/S_/93,4329,2209,2120,1549
243,ทต.ตันหยง,TH/S_/94/ทต.ตันหยง,TH/S_/94,2806,1485,1321,730
244,ทต.ตันหยงมัส,TH/S_/96/ทต.ตันหยงมัส,TH/S_/96,7054,3652,3402,3808
245,ทต.ตากฟ้า,TH/CT/60/ทต.ตากฟ้า,TH/CT/60,5472,2828,2644,2738
246,ทต.ตาจง,TH/NE/31/ทต.ตาจง,TH/NE/31,16584,8229,8355,4309
247,ทต.ตาพระยา,TH/E_/27/ทต.ตาพระยา,TH/E_/27,2644,1337,1307,1145
248,ทต.ตาลสุม,TH/NE/34/ทต.ตาลสุม,TH/NE/34,3237,1633,1604,1066
249,ทต.ตาลเลียน,TH/NE/41/ทต.ตาลเลียน,TH/NE/41,3718,1840,1878,878
250,ทต.ต้นคราม,TH/CT/72/ทต.ต้นคราม,TH/CT/72,5506,2890,2616,2025
251,ทต.ต้นไทร,TH/S_/96/ทต.ต้นไทร,TH/S_/96,4902,2564,2338,1354
252,ทต.ถนนใหญ่,TH/CT/16/ทต.ถนนใหญ่,TH/CT/16,11018,5022,5996,4730
253,ทต.ถอนสมอ,TH/CT/17/ทต.ถอนสมอ,TH/CT/17,8748,4568,4180,3405
254,ทต.ถาวร,TH/NE/31/ทต.ถาวร,TH/NE/31,7653,3841,3812,2175
255,ทต.ทรายขาว,TH/E_/22/ทต.ทรายขาว,TH/E_/22,11326,5724,5602,6318
256,ทต.ทรายมูล,TH/NE/35/ทต.ทรายมูล,TH/NE/35,6270,3223,3047,2094
257,ทต.ทองผาภูมิ,TH/W_/71/ทต.ทองผาภูมิ,TH/W_/71,3095,1513,1582,1569
258,ทต.ทองแสนขัน,TH/N_/53/ทต.ทองแสนขัน,TH/N_/53,4569,2351,2218,1807
259,ทต.ทอนหงส์,TH/S_/นครศรีธรรมราช/ทต.ทอนหงส์,TH/S_/นครศรีธรรมราช,3429,1710,1719,1050
260,ทต.ทะเมนชัย,TH/NE/31/ทต.ทะเมนชัย,TH/NE/31,4381,2206,2175,1247
261,ทต.ทับกฤช,TH/CT/60/ทต.ทับกฤช,TH/CT/60,2162,1134,1028,820
262,ทต.ทับคล้อ,TH/CT/66/ทต.ทับคล้อ,TH/CT/66,4448,2321,2127,1753
263,ทต.ทับช้าง,TH/E_/22/ทต.ทับช้าง,TH/E_/22,16373,8113,8260,6030
264,ทต.ทับปุด,TH/S_/82/ทต.ทับปุด,TH/S_/82,1025,528,497,650
265,ทต.ทับมา,TH/E_/21/ทต.ทับมา,TH/E_/21,25022,12562,12460,16938
266,ทต.ทับสะแก,TH/W_/ประจวบคีรีขันธ์/ทต.ทับสะแก,TH/W_/ประจวบคีรีขันธ์,6591,3463,3128,3462
267,ทต.ทัพทัน,TH/CT/61/ทต.ทัพทัน,TH/CT/61,8851,4635,4216,3614
268,ทต.ทากาศ,TH/N_/51/ทต.ทากาศ,TH/N_/51,2977,1565,1412,1394
269,ทต.ทางพูน,TH/S_/นครศรีธรรมราช/ทต.ทางพูน,TH/S_/นครศรีธรรมราช,8890,4358,4532,2846
270,ทต.ทาสบชัย,TH/N_/51/ทต.ทาสบชัย,TH/N_/51,4958,2541,2417,2261
271,ทต.ทาสบเส้า,TH/N_/51/ทต.ทาสบเส้า,TH/N_/51,5337,2756,2581,2510
272,ทต.ที่วัง,TH/S_/นครศรีธรรมราช/ทต.ที่วัง,TH/S_/นครศรีธรรมราช,14192,7086,7106,6364
273,ทต.ทุ่งกระเชาะ,TH/W_/63/ทต.ทุ่งกระเชาะ,TH/W_/63,6034,3045,2989,2101
274,ทต.ทุ่งข้าวพวง,TH/N_/เชียงใหม่/ทต.ทุ่งข้าวพวง,TH/N_/เชียงใหม่,10842,5388,5454,3033
275,ทต.ทุ่งควายกิน,TH/E_/21/ทต.ทุ่งควายกิน,TH/E_/21,6639,3451,3188,3922
276,ทต.ทุ่งคอก,TH/CT/72/ทต.ทุ่งคอก,TH/CT/72,3331,1789,1542,1260
277,ทต.ทุ่งช้าง,TH/N_/55/ทต.ทุ่งช้าง,TH/N_/55,3351,1642,1709,1419
278,ทต.ทุ่งทราย,TH/CT/62/ทต.ทุ่งทราย,TH/CT/62,8800,4490,4310,3233
279,ทต.ทุ่งฝน,TH/NE/41/ทต.ทุ่งฝน,TH/NE/41,7221,3772,3449,2180
280,ทต.ทุ่งยั้ง,TH/N_/53/ทต.ทุ่งยั้ง,TH/N_/53,9807,5224,4583,4080
281,ทต.ทุ่งยาว,TH/S_/92/ทต.ทุ่งยาว,TH/S_/92,2464,1317,1147,1092
282,ทต.ทุ่งลาน,TH/S_/90/ทต.ทุ่งลาน,TH/S_/90,7356,3785,3571,2499
283,ทต.ทุ่งสะเดา,TH/E_/24/ทต.ทุ่งสะเดา,TH/E_/24,5376,2313,3063,3987
284,ทต.ทุ่งหลวง,TH/CT/64/ทต.ทุ่งหลวง,TH/CT/64,7136,3722,3414,2382
285,ทต.ทุ่งหลวง,TH/W_/70/ทต.ทุ่งหลวง,TH/W_/70,13769,6899,6870,4296
286,ทต.ทุ่งหลวง,TH/S_/84/ทต.ทุ่งหลวง,TH/S_/84,11305,5810,5495,4164
287,ทต.ทุ่งหว้า,TH/S_/91/ทต.ทุ่งหว้า,TH/S_/91,3239,1653,1586,1231
288,ทต.ทุ่งหัวช้าง,TH/N_/51/ทต.ทุ่งหัวช้าง,TH/N_/51,2527,1264,1263,1217
289,ทต.ทุ่งเสลี่ยม,TH/CT/64/ทต.ทุ่งเสลี่ยม,TH/CT/64,7417,3925,3492,3018
290,ทต.ทุ่งโฮ้ง,TH/N_/54/ทต.ทุ่งโฮ้ง,TH/N_/54,6111,3255,2856,3139
291,ทต.ท่าขนอน,TH/S_/84/ทต.ท่าขนอน,TH/S_/84,1927,962,965,1095
292,ทต.ท่าขอนยาง,TH/NE/44/ทต.ท่าขอนยาง,TH/NE/44,8858,4601,4257,6327
293,ทต.ท่าข้าม,TH/E_/24/ทต.ท่าข้าม,TH/E_/24,7630,3963,3667,8858
294,ทต.ท่าข้าม,TH/CT/67/ทต.ท่าข้าม,TH/CT/67,2492,1239,1253,968
295,ทต.ท่าข้าม,TH/S_/92/ทต.ท่าข้าม,TH/S_/92,1396,690,706,661
296,ทต.ท่าข้าม,TH/N_/เชียงใหม่/ทต.ท่าข้าม,TH/N_/เชียงใหม่,5748,2989,2759,3461
297,ทต.ท่าคันโท,TH/NE/46/ทต.ท่าคันโท,TH/NE/46,9134,4598,4536,2898
298,ทต.ท่าฉาง,TH/S_/84/ทต.ท่าฉาง,TH/S_/84,4766,2466,2300,1923
299,ทต.ท่าชนะ,TH/S_/84/ทต.ท่าชนะ,TH/S_/84,2912,1531,1381,1746
300,ทต.ท่าช้าง,TH/CT/26/ทต.ท่าช้าง,TH/CT/26,968,485,483,332
301,ทต.ท่าช้าง,TH/NE/30/ทต.ท่าช้าง,TH/NE/30,5021,2603,2418,2056
302,ทต.ท่าช้าง,TH/S_/90/ทต.ท่าช้าง,TH/S_/90,22110,11139,10971,9709
303,ทต.ท่าตะโก,TH/CT/60/ทต.ท่าตะโก,TH/CT/60,5631,2992,2639,2878
304,ทต.ท่าตูม,TH/S_/32/ทต.ท่าตูม,TH/S_/32,4091,2105,1986,1797
305,ทต.ท่าทองใหม่,TH/S_/84/ทต.ท่าทองใหม่,TH/S_/84,7054,3573,3481,3112
306,ทต.ท่านา,TH/S_/82/ทต.ท่านา,TH/S_/82,1042,539,503,590
307,ทต.ท่าน้ำอ้อยม่วงหัก,TH/CT/60/ทต.ท่าน้ำอ้อยม่วงหัก,TH/CT/60,5059,2631,2428,2737
308,ทต.ท่าบุญมี,TH/E_/ชลบุรี/ทต.ท่าบุญมี,TH/E_/ชลบุรี,6762,3481,3281,4145
309,ทต.ท่าปลา,TH/N_/53/ทต.ท่าปลา,TH/N_/53,2291,1200,1091,930
310,ทต.ท่าพระ,TH/NE/ขอนแก่น/ทต.ท่าพระ,TH/NE/ขอนแก่น,8953,4684,4269,4036
311,ทต.ท่าพริกเนินทราย,TH/E_/23/ทต.ท่าพริกเนินทราย,TH/E_/23,6634,3449,3185,2996
312,ทต.ท่าพล,TH/CT/67/ทต.ท่าพล,TH/CT/67,7637,3990,3647,2570
313,ทต.ท่าพุทรา,TH/CT/62/ทต.ท่าพุทรา,TH/CT/62,1521,767,754,625
314,ทต.ท่ามะกา,TH/W_/71/ทต.ท่ามะกา,TH/W_/71,8633,4606,4027,4687
315,ทต.ท่ามะเขือ,TH/CT/62/ทต.ท่ามะเขือ,TH/CT/62,3605,1860,1745,2024
316,ทต.ท่ามะเดื่อ,TH/S_/93/ทต.ท่ามะเดื่อ,TH/S_/93,4170,2161,2009,1785
317,ทต.ท่าม่วง,TH/W_/71/ทต.ท่าม่วง,TH/W_/71,10032,5375,4657,5460
318,ทต.ท่ายาง,TH/W_/76/ทต.ท่ายาง,TH/W_/76,27996,14713,13283,11452
319,ทต.ท่ายาง,TH/S_/86/ทต.ท่ายาง,TH/S_/86,10247,5206,5041,4663
320,ทต.ท่ายาง,TH/S_/นครศรีธรรมราช/ทต.ท่ายาง,TH/S_/นครศรีธรรมราช,5163,2713,2450,3021
321,ทต.ท่าระหัด,TH/CT/72/ทต.ท่าระหัด,TH/CT/72,8994,4872,4122,4993
322,ทต.ท่าลาน,TH/CT/19/ทต.ท่าลาน,TH/CT/19,7903,4094,3809,3996
323,ทต.ท่าลี่,TH/NE/42/ทต.ท่าลี่,TH/NE/42,1998,1042,956,815
324,ทต.ท่าล้อ,TH/W_/71/ทต.ท่าล้อ,TH/W_/71,9067,4759,4308,3878
325,ทต.ท่าวังทอง,TH/N_/56/ทต.ท่าวังทอง,TH/N_/56,15726,7632,8094,9546
326,ทต.ท่าวังผา,TH/N_/55/ทต.ท่าวังผา,TH/N_/55,5161,2686,2475,2700
327,ทต.ท่าวุ้ง,TH/CT/16/ทต.ท่าวุ้ง,TH/CT/16,2148,1125,1023,910
328,ทต.ท่าศาลา,TH/CT/16/ทต.ท่าศาลา,TH/CT/16,14713,7800,6913,7083
329,ทต.ท่าศาลา,TH/S_/นครศรีธรรมราช/ทต.ท่าศาลา,TH/S_/นครศรีธรรมราช,2868,1521,1347,1771
330,ทต.ท่าศาลา,TH/N_/เชียงใหม่/ทต.ท่าศาลา,TH/N_/เชียงใหม่,7028,3777,3251,5433
331,ทต.ท่าสะอาด,TH/NE/38/ทต.ท่าสะอาด,TH/NE/38,6897,3495,3402,1993
332,ทต.ท่าสะอ้าน,TH/E_/24/ทต.ท่าสะอ้าน,TH/E_/24,3198,1665,1533,2428
333,ทต.ท่าสัก,TH/N_/53/ทต.ท่าสัก,TH/N_/53,1203,629,574,567
334,ทต.ท่าสายลวด,TH/W_/63/ทต.ท่าสายลวด,TH/W_/63,24544,11889,12655,4641
335,ทต.ท่าหลวง,TH/CT/14/ทต.ท่าหลวง,TH/CT/14,8423,4464,3959,4118
336,ทต.ท่าฬ่อ,TH/CT/66/ทต.ท่าฬ่อ,TH/CT/66,3201,1665,1536,1194
337,ทต.ท่าอุเทน,TH/NE/48/ทต.ท่าอุเทน,TH/NE/48,4839,2498,2341,1947
338,ทต.ท่าเกษม,TH/E_/27/ทต.ท่าเกษม,TH/E_/27,3611,1901,1710,1602
339,ทต.ท่าเดื่อ-มืดกา,TH/N_/เชียงใหม่/ทต.ท่าเดื่อ-มืดกา,TH/N_/เชียงใหม่,4293,2202,2091,1859
340,ทต.ท่าเยี่ยม,TH/NE/30/ทต.ท่าเยี่ยม,TH/NE/30,11211,5678,5533,5332
341,ทต.ท่าเรือ,TH/CT/14/ทต.ท่าเรือ,TH/CT/14,6528,3468,3060,3174
342,ทต.ท่าเสด็จ,TH/CT/72/ทต.ท่าเสด็จ,TH/CT/72,13931,7184,6747,4361
343,ทต.ท่าเสา,TH/N_/53/ทต.ท่าเสา,TH/N_/53,14691,7123,7568,7454
344,ทต.ท่าเสา,TH/CT/66/ทต.ท่าเสา,TH/CT/66,1487,738,749,524
345,ทต.ท่าแซะ,TH/S_/86/ทต.ท่าแซะ,TH/S_/86,2034,1076,958,1355
346,ทต.ท่าแพ,TH/S_/นครศรีธรรมราช/ทต.ท่าแพ,TH/S_/นครศรีธรรมราช,4014,2044,1970,1286
347,ทต.ท่าแร่,TH/NE/47/ทต.ท่าแร่,TH/NE/47,6714,3484,3230,2323
348,ทต.ท่าแลง,TH/W_/76/ทต.ท่าแลง,TH/W_/76,6211,3232,2979,2158
349,ทต.ท่าโขลง,TH/CT/16/ทต.ท่าโขลง,TH/CT/16,2277,1217,1060,994
350,ทต.ท่าไม้,TH/W_/71/ทต.ท่าไม้,TH/W_/71,9175,4731,4444,3847
351,ทต.ท้องเนียน,TH/S_/นครศรีธรรมราช/ทต.ท้องเนียน,TH/S_/นครศรีธรรมราช,5576,2793,2783,3253
352,ทต.ท้ายดง,TH/CT/67/ทต.ท้ายดง,TH/CT/67,3467,1785,1682,1061
353,ทต.ท้ายเหมือง,TH/S_/82/ทต.ท้ายเหมือง,TH/S_/82,3318,1719,1599,1744
354,ทต.ท้าวอู่ทอง,TH/CT/72/ทต.ท้าวอู่ทอง,TH/CT/72,15843,8158,7685,5812
355,ทต.ธงธานี,TH/NE/45/ทต.ธงธานี,TH/NE/45,7774,4015,3759,2490
356,ทต.ธรรมศาลา,TH/CT/73/ทต.ธรรมศาลา,TH/CT/73,6939,3643,3296,2970
357,ทต.ธัญญา,TH/NE/46/ทต.ธัญญา,TH/NE/46,6348,3232,3116,1699
358,ทต.ธัญบุรี,TH/CT/ปทุมธานี/ทต.ธัญบุรี,TH/CT/ปทุมธานี,63070,33108,29962,33989
359,ทต.ธาตุ,TH/NE/42/ทต.ธาตุ,TH/NE/42,9785,4917,4868,3364
360,ทต.ธาตุทอง,TH/E_/ชลบุรี/ทต.ธาตุทอง,TH/E_/ชลบุรี,7869,4000,3869,2721
361,ทต.ธาตุพนม,TH/NE/48/ทต.ธาตุพนม,TH/NE/48,10031,5157,4874,4113
362,ทต.นครชัยศรี,TH/CT/73/ทต.นครชัยศรี,TH/CT/73,8183,4427,3756,5052
363,ทต.นครชุม,TH/CT/62/ทต.นครชุม,TH/CT/62,6890,3653,3237,3454
364,ทต.นครหลวง,TH/CT/14/ทต.นครหลวง,TH/CT/14,6969,3650,3319,3027
365,ทต.นครเนื่องเขต,TH/E_/24/ทต.นครเนื่องเขต,TH/E_/24,1475,780,695,496
366,ทต.นครไทย,TH/CT/65/ทต.นครไทย,TH/CT/65,9036,4661,4375,4088
367,ทต.นากลาง,TH/NE/39/ทต.นากลาง,TH/NE/39,20213,10266,9947,6601
368,ทต.นาขาม,TH/NE/46/ทต.นาขาม,TH/NE/46,12963,6541,6422,3366
369,ทต.นาข่า,TH/NE/41/ทต.นาข่า,TH/NE/41,6441,3315,3126,2565
370,ทต.นาคำไฮ,TH/NE/39/ทต.นาคำไฮ,TH/NE/39,4997,2518,2479,1427
371,ทต.นาคู,TH/NE/46/ทต.นาคู,TH/NE/46,5324,2773,2551,1913
372,ทต.นางบวช,TH/CT/72/ทต.นางบวช,TH/CT/72,4374,2260,2114,1624
373,ทต.นางลือ,TH/CT/18/ทต.นางลือ,TH/CT/18,7579,3982,3597,2570
374,ทต.นางัว,TH/NE/41/ทต.นางัว,TH/NE/41,9105,4605,4500,3410
375,ทต.นางั่ว,TH/CT/67/ทต.นางั่ว,TH/CT/67,12859,6792,6067,5647
376,ทต.นางแล,TH/N_/57/ทต.นางแล,TH/N_/57,11648,6062,5586,5737
377,ทต.นาจอมเทียน,TH/E_/ชลบุรี/ทต.นาจอมเทียน,TH/E_/ชลบุรี,8026,4237,3789,15653
378,ทต.นาจะหลวย,TH/NE/34/ทต.นาจะหลวย,TH/NE/34,7306,3638,3668,2637
379,ทต.นาจารย์,TH/NE/46/ทต.นาจารย์,TH/NE/46,8487,4259,4228,2493
380,ทต.นาดอกคำ,TH/NE/42/ทต.นาดอกคำ,TH/NE/42,10002,4933,5069,3021
381,ทต.นาดินดำ,TH/NE/42/ทต.นาดินดำ,TH/NE/42,10660,5306,5354,3665
382,ทต.นาดี,TH/E_/25/ทต.นาดี,TH/E_/25,7922,4022,3900,3306
383,ทต.นาดี,TH/CT/74/ทต.นาดี,TH/CT/74,28095,14813,13282,16548
384,ทต.นาดูน,TH/NE/44/ทต.นาดูน,TH/NE/44,4734,2346,2388,1773
385,ทต.นาด้วง,TH/NE/42/ทต.นาด้วง,TH/NE/42,6673,3344,3329,2355
386,ทต.นาทวี,TH/S_/90/ทต.นาทวี,TH/S_/90,6469,3254,3215,3683
387,ทต.นาทัน,TH/NE/46/ทต.นาทัน,TH/NE/46,14251,7046,7205,3676
388,ทต.นาน้อย,TH/N_/55/ทต.นาน้อย,TH/N_/55,2416,1279,1137,1221
389,ทต.นาบอน,TH/S_/นครศรีธรรมราช/ทต.นาบอน,TH/S_/นครศรีธรรมราช,2279,1159,1120,1139
390,ทต.นาประดู่,TH/S_/94/ทต.นาประดู่,TH/S_/94,3117,1608,1509,1403
391,ทต.นาป่า,TH/E_/ชลบุรี/ทต.นาป่า,TH/E_/ชลบุรี,41353,21052,20301,25817
392,ทต.นามน,TH/NE/46/ทต.นามน,TH/NE/46,7002,3506,3496,2335
393,ทต.นามะเฟือง,TH/NE/39/ทต.นามะเฟือง,TH/NE/39,4145,2143,2002,1081
394,ทต.นายม,TH/NE/37/ทต.นายม,TH/NE/37,5243,2650,2593,1542
395,ทต.นายาง,TH/W_/76/ทต.นายาง,TH/W_/76,18882,9774,9108,7030
396,ทต.นายายอาม,TH/E_/22/ทต.นายายอาม,TH/E_/22,3530,1844,1686,1959
397,ทต.นาวง,TH/S_/92/ทต.นาวง,TH/S_/92,4045,2079,1966,1792
398,ทต.นาสีทอง,TH/S_/90/ทต.นาสีทอง,TH/S_/90,2915,1534,1381,1107
399,ทต.นาส่วง,TH/NE/34/ทต.นาส่วง,TH/NE/34,3149,1629,1520,985
400,ทต.นาหนองทุ่ม,TH/NE/36/ทต.นาหนองทุ่ม,TH/NE/36,10892,5629,5263,3278
401,ทต.นาหว้า,TH/NE/48/ทต.นาหว้า,TH/NE/48,12193,6174,6019,4195
402,ทต.นาอาน,TH/NE/42/ทต.นาอาน,TH/NE/42,12708,6447,6261,5783
403,ทต.นาอ้อ,TH/NE/42/ทต.นาอ้อ,TH/NE/42,6099,3131,2968,2231
404,ทต.นาเฉลียง,TH/CT/67/ทต.นาเฉลียง,TH/CT/67,4262,2231,2031,1731
405,ทต.นาเชือก,TH/NE/44/ทต.นาเชือก,TH/NE/44,3784,1941,1843,2069
406,ทต.นาเยีย,TH/NE/34/ทต.นาเยีย,TH/NE/34,6523,3313,3210,1833
407,ทต.นาเหล่า,TH/NE/39/ทต.นาเหล่า,TH/NE/39,6931,3553,3378,2420
408,ทต.นาแก,TH/NE/48/ทต.นาแก,TH/NE/48,4384,2320,2064,2327
409,ทต.นาแก้ว,TH/N_/52/ทต.นาแก้ว,TH/N_/52,8931,4558,4373,3104
410,ทต.นาแห้ว,TH/NE/42/ทต.นาแห้ว,TH/NE/42,2015,984,1031,888
411,ทต.นาโป่ง,TH/NE/42/ทต.นาโป่ง,TH/NE/42,10262,5166,5096,3452
412,ทต.นาโพธิ์,TH/NE/31/ทต.นาโพธิ์,TH/NE/31,3673,1903,1770,1636
413,ทต.นาโพธิ์,TH/S_/86/ทต.นาโพธิ์,TH/S_/86,2940,1565,1375,1676
414,ทต.นาโยงเหนือ,TH/S_/92/ทต.นาโยงเหนือ,TH/S_/92,3523,1849,1674,1551
415,ทต.นิคมคำสร้อย,TH/NE/49/ทต.นิคมคำสร้อย,TH/NE/49,6246,3186,3060,2305
416,ทต.นิคมทุ่งโพธิ์ทะเล,TH/CT/62/ทต.นิคมทุ่งโพธิ์ทะเล,TH/CT/62,9204,4693,4511,3613
417,ทต.นิคมปราสาท,TH/S_/32/ทต.นิคมปราสาท,TH/S_/32,2685,1354,1331,849
418,ทต.นิคมสงเคราะห์,TH/NE/41/ทต.นิคมสงเคราะห์,TH/NE/41,3714,1913,1801,1296
419,ทต.นิเวศน์,TH/NE/45/ทต.นิเวศน์,TH/NE/45,6729,3399,3330,3013
420,ทต.น้ำคำ,TH/NE/33/ทต.น้ำคำ,TH/NE/33,10519,5341,5178,3000
421,ทต.น้ำจืด,TH/S_/85/ทต.น้ำจืด,TH/S_/85,3674,1854,1820,1918
422,ทต.น้ำตกไทรโยคน้อย,TH/W_/71/ทต.น้ำตกไทรโยคน้อย,TH/W_/71,3926,1991,1935,1572
423,ทต.น้ำน้อย,TH/S_/90/ทต.น้ำน้อย,TH/S_/90,14786,7814,6972,6044
424,ทต.น้ำปลีก,TH/NE/37/ทต.น้ำปลีก,TH/NE/37,3781,1958,1823,1234
425,ทต.น้ำปาด,TH/N_/53/ทต.น้ำปาด,TH/N_/53,2946,1552,1394,1581
426,ทต.น้ำพอง,TH/NE/ขอนแก่น/ทต.น้ำพอง,TH/NE/ขอนแก่น,4950,2564,2386,2433
427,ทต.น้ำยืน,TH/NE/34/ทต.น้ำยืน,TH/NE/34,9036,4546,4490,3378
428,ทต.น้ำริด,TH/N_/53/ทต.น้ำริด,TH/N_/53,6898,3504,3394,2579
429,ทต.น้ำสวย,TH/NE/42/ทต.น้ำสวย,TH/NE/42,3584,1815,1769,1215
430,ทต.น้ำเชี่ยว,TH/E_/23/ทต.น้ำเชี่ยว,TH/E_/23,3290,1701,1589,1333
431,ทต.น้ำโจ้,TH/N_/52/ทต.น้ำโจ้,TH/N_/52,9629,4897,4732,3495
432,ทต.น้ำโสม,TH/NE/41/ทต.น้ำโสม,TH/NE/41,8671,4417,4254,2547
433,ทต.บงใต้,TH/NE/47/ทต.บงใต้,TH/NE/47,10183,5049,5134,2955
434,ทต.บรบือ,TH/NE/44/ทต.บรบือ,TH/NE/44,5671,3056,2615,2320
435,ทต.บรรพตพิสัย,TH/CT/60/ทต.บรรพตพิสัย,TH/CT/60,3855,2016,1839,1828
436,ทต.บวกค้าง,TH/N_/เชียงใหม่/ทต.บวกค้าง,TH/N_/เชียงใหม่,8537,4470,4067,3874
437,ทต.บันนังสตา,TH/S_/95/ทต.บันนังสตา,TH/S_/95,2611,1300,1311,979
438,ทต.บัลลังก์,TH/NE/30/ทต.บัลลังก์,TH/NE/30,7821,3918,3903,2436
439,ทต.บัวงาม,TH/NE/34/ทต.บัวงาม,TH/NE/34,6740,3358,3382,1854
440,ทต.บัวบาน,TH/NE/46/ทต.บัวบาน,TH/NE/46,12993,6660,6333,4429
441,ทต.บัววัฒนา,TH/CT/67/ทต.บัววัฒนา,TH/CT/67,5891,2940,2951,1885
442,ทต.บัวเชด,TH/S_/32/ทต.บัวเชด,TH/S_/32,6490,3291,3199,2381
443,ทต.บางกระทึก,TH/CT/73/ทต.บางกระทึก,TH/CT/73,13537,7261,6276,8744
444,ทต.บางกระทุ่ม,TH/CT/65/ทต.บางกระทุ่ม,TH/CT/65,1392,709,683,615
445,ทต.บางกระสั้น,TH/CT/14/ทต.บางกระสั้น,TH/CT/14,13162,6999,6163,5629
446,ทต.บางกะจะ,TH/E_/22/ทต.บางกะจะ,TH/E_/22,5112,2638,2474,2164
447,ทต.บางกุ้ง,TH/CT/72/ทต.บางกุ้ง,TH/CT/72,1915,996,919,584
448,ทต.บางขนาก,TH/E_/24/ทต.บางขนาก,TH/E_/24,2084,1038,1046,782
449,ทต.บางคล้า,TH/E_/24/ทต.บางคล้า,TH/E_/24,9281,4990,4291,4853
450,ทต.บางจัก,TH/CT/15/ทต.บางจัก,TH/CT/15,7668,3998,3670,2777
451,ทต.บางจาก,TH/S_/นครศรีธรรมราช/ทต.บางจาก,TH/S_/นครศรีธรรมราช,1817,952,865,659
452,ทต.บางซ้าย,TH/CT/14/ทต.บางซ้าย,TH/CT/14,5248,2680,2568,1831
453,ทต.บางตะบูน,TH/W_/76/ทต.บางตะบูน,TH/W_/76,5137,2633,2504,1862
454,ทต.บางทราย,TH/E_/ชลบุรี/ทต.บางทราย,TH/E_/ชลบุรี,11679,5246,6433,7448
455,ทต.บางนกแขวก,TH/CT/75/ทต.บางนกแขวก,TH/CT/75,1742,948,794,853
456,ทต.บางนมโค,TH/CT/14/ทต.บางนมโค,TH/CT/14,7507,3957,3550,4080
457,ทต.บางน้ำเชี่ยว,TH/CT/17/ทต.บางน้ำเชี่ยว,TH/CT/17,3406,1781,1625,1362
458,ทต.บางน้ำเปรี้ยว,TH/E_/24/ทต.บางน้ำเปรี้ยว,TH/E_/24,2355,1203,1152,1188
459,ทต.บางบาล,TH/CT/14/ทต.บางบาล,TH/CT/14,11012,5793,5219,3713
460,ทต.บางบ่อ,TH/CT/11/ทต.บางบ่อ,TH/CT/11,6445,3362,3083,2331
461,ทต.บางประมุง,TH/CT/60/ทต.บางประมุง,TH/CT/60,5021,2552,2469,1565
462,ทต.บางปลา,TH/CT/74/ทต.บางปลา,TH/CT/74,6962,3604,3358,4327
463,ทต.บางปลาม้า,TH/CT/72/ทต.บางปลาม้า,TH/CT/72,1928,990,938,662
464,ทต.บางปะกง,TH/E_/24/ทต.บางปะกง,TH/E_/24,6158,3232,2926,2903
465,ทต.บางปะหัน,TH/CT/14/ทต.บางปะหัน,TH/CT/14,5290,2795,2495,2219
466,ทต.บางปะอิน,TH/CT/14/ทต.บางปะอิน,TH/CT/14,6807,3454,3353,2193
467,ทต.บางปู,TH/CT/11/ทต.บางปู,TH/CT/11,119500,61898,57602,59612
468,ทต.บางปู,TH/S_/94/ทต.บางปู,TH/S_/94,10413,5230,5183,2257
469,ทต.บางพระ,TH/E_/ชลบุรี/ทต.บางพระ,TH/E_/ชลบุรี,13380,6986,6394,7709
470,ทต.บางพลับ,TH/CT/12/ทต.บางพลับ,TH/CT/12,10899,5831,5068,5979
471,ทต.บางพลี,TH/CT/11/ทต.บางพลี,TH/CT/11,11837,5934,5903,2197
472,ทต.บางพูน,TH/CT/ปทุมธานี/ทต.บางพูน,TH/CT/ปทุมธานี,25783,13615,12168,19879
473,ทต.บางม่วง,TH/CT/12/ทต.บางม่วง,TH/CT/12,6101,3107,2994,2753
474,ทต.บางระกำ,TH/CT/65/ทต.บางระกำ,TH/CT/65,4279,2249,2030,1975
475,ทต.บางละมุง,TH/E_/ชลบุรี/ทต.บางละมุง,TH/E_/ชลบุรี,12484,6524,5960,8982
476,ทต.บางวัว,TH/E_/24/ทต.บางวัว,TH/E_/24,2972,1550,1422,1956
477,ทต.บางวัวคณารักษ์,TH/E_/24/ทต.บางวัวคณารักษ์,TH/E_/24,11081,5783,5298,8208
478,ทต.บางสวรรค์,TH/S_/84/ทต.บางสวรรค์,TH/S_/84,4039,2027,2012,1929
479,ทต.บางสะพานน้อย,TH/W_/ประจวบคีรีขันธ์/ทต.บางสะพานน้อย,TH/W_/ประจวบคีรีขันธ์,2953,1492,1461,1503
480,ทต.บางหลวง,TH/CT/18/ทต.บางหลวง,TH/CT/18,5381,2844,2537,2610
481,ทต.บางหลวง,TH/CT/73/ทต.บางหลวง,TH/CT/73,2108,1090,1018,769
482,ทต.บางหลวง,TH/CT/ปทุมธานี/ทต.บางหลวง,TH/CT/ปทุมธานี,7133,3729,3404,4485
483,ทต.บางเตย,TH/CT/ปทุมธานี/ทต.บางเตย,TH/CT/ปทุมธานี,10973,5631,5342,4494
484,ทต.บางเมือง,TH/CT/11/ทต.บางเมือง,TH/CT/11,99726,53123,46603,50039
485,ทต.บางเลน,TH/CT/73/ทต.บางเลน,TH/CT/73,8437,4221,4216,4094
486,ทต.บางเสร่,TH/E_/ชลบุรี/ทต.บางเสร่,TH/E_/ชลบุรี,11588,6257,5331,9206
487,ทต.บางเสาธง,TH/CT/11/ทต.บางเสาธง,TH/CT/11,21754,11349,10405,17089
488,ทต.บางแก้ว,TH/S_/93/ทต.บางแก้ว,TH/S_/93,3798,1933,1865,1421
489,ทต.บางแพ,TH/W_/70/ทต.บางแพ,TH/W_/70,16109,8418,7691,6461
490,ทต.บางใหญ่,TH/CT/12/ทต.บางใหญ่,TH/CT/12,12083,6259,5824,5813
491,ทต.บางไทร,TH/CT/14/ทต.บางไทร,TH/CT/14,10247,5230,5017,3779
492,ทต.บางไผ่,TH/CT/66/ทต.บางไผ่,TH/CT/66,1516,797,719,627
493,ทต.บาเจาะ,TH/S_/96/ทต.บาเจาะ,TH/S_/96,9518,4760,4758,2277
494,ทต.บำเหน็จณรงค์,TH/NE/36/ทต.บำเหน็จณรงค์,TH/NE/36,6977,3625,3352,2964
495,ทต.บึงบูรพ์,TH/NE/33/ทต.บึงบูรพ์,TH/NE/33,6161,3157,3004,1803
496,ทต.บึงระมาณ,TH/CT/65/ทต.บึงระมาณ,TH/CT/65,4401,2276,2125,1676
497,ทต.บึงโขงหลง,TH/NE/38/ทต.บึงโขงหลง,TH/NE/38,9777,4930,4847,3335
498,ทต.บุญเรือง,TH/N_/57/ทต.บุญเรือง,TH/N_/57,5992,3072,2920,2513
499,ทต.บุณฑริก,TH/NE/34/ทต.บุณฑริก,TH/NE/34,4455,2261,2194,2064
500,ทต.บุสูง,TH/NE/33/ทต.บุสูง,TH/NE/33,10281,5075,5206,2769
501,ทต.บูเก๊ะตา,TH/S_/96/ทต.บูเก๊ะตา,TH/S_/96,5042,2575,2467,1381
502,ทต.บ่อ,TH/E_/22/ทต.บ่อ,TH/E_/22,7215,3687,3528,2623
503,ทต.บ่อกรุ,TH/CT/72/ทต.บ่อกรุ,TH/CT/72,1978,1051,927,741
504,ทต.บ่อตรุ,TH/S_/90/ทต.บ่อตรุ,TH/S_/90,11106,5659,5447,3472
505,ทต.บ่อทอง,TH/S_/94/ทต.บ่อทอง,TH/S_/94,16517,6323,10194,5868
506,ทต.บ่อทอง,TH/E_/ชลบุรี/ทต.บ่อทอง,TH/E_/ชลบุรี,4241,2151,2090,2041
507,ทต.บ่อพลอย,TH/E_/23/ทต.บ่อพลอย,TH/E_/23,8763,4396,4367,5648
508,ทต.บ่อพลอย,TH/W_/71/ทต.บ่อพลอย,TH/W_/71,6980,3512,3468,2703
509,ทต.บ่อพลับ,TH/CT/73/ทต.บ่อพลับ,TH/CT/73,9545,5010,4535,4770
510,ทต.บ่อหลวง,TH/N_/เชียงใหม่/ทต.บ่อหลวง,TH/N_/เชียงใหม่,12126,6030,6096,3829
511,ทต.บ่อเวฬุ,TH/E_/22/ทต.บ่อเวฬุ,TH/E_/22,4374,2074,2300,2511
512,ทต.บ่อแฮ้ว,TH/N_/52/ทต.บ่อแฮ้ว,TH/N_/52,9083,4793,4290,4123
513,ทต.บ่อไทย,TH/CT/67/ทต.บ่อไทย,TH/CT/67,9616,4894,4722,2983
514,ทต.บ้านกรวด,TH/NE/31/ทต.บ้านกรวด,TH/NE/31,3955,2003,1952,1953
515,ทต.บ้านกรวดปัญญาวัฒน์,TH/NE/31/ทต.บ้านกรวดปัญญาวัฒน์,TH/NE/31,9324,4666,4658,2677
516,ทต.บ้านกรูด,TH/W_/ประจวบคีรีขันธ์/ทต.บ้านกรูด,TH/W_/ประจวบคีรีขันธ์,4170,2189,1981,2294
517,ทต.บ้านกลาง,TH/N_/51/ทต.บ้านกลาง,TH/N_/51,11394,6131,5263,11061
518,ทต.บ้านกลาง,TH/CT/ปทุมธานี/ทต.บ้านกลาง,TH/CT/ปทุมธานี,12401,6538,5863,6357
519,ทต.บ้านกลาง,TH/N_/เชียงใหม่/ทต.บ้านกลาง,TH/N_/เชียงใหม่,10284,5456,4828,5320
520,ทต.บ้านกล้วย,TH/CT/18/ทต.บ้านกล้วย,TH/CT/18,6957,3661,3296,3493
521,ทต.บ้านกล้วย,TH/CT/64/ทต.บ้านกล้วย,TH/CT/64,16128,8535,7593,7105
522,ทต.บ้านค่าย,TH/E_/21/ทต.บ้านค่าย,TH/E_/21,3324,1756,1568,2022
523,ทต.บ้านค่ายหมื่นแผ้ว,TH/NE/36/ทต.บ้านค่ายหมื่นแผ้ว,TH/NE/36,4948,2535,2413,1894
524,ทต.บ้านค้อ,TH/NE/ขอนแก่น/ทต.บ้านค้อ,TH/NE/ขอนแก่น,16927,8563,8364,6665
525,ทต.บ้านฆ้อง,TH/W_/70/ทต.บ้านฆ้อง,TH/W_/70,8642,4531,4111,3433
526,ทต.บ้านจั่น,TH/NE/41/ทต.บ้านจั่น,TH/NE/41,7020,3759,3261,3324
527,ทต.บ้านฉาง,TH/E_/21/ทต.บ้านฉาง,TH/E_/21,14415,7320,7095,8481
528,ทต.บ้านชัฏป่าหวาย,TH/W_/70/ทต.บ้านชัฏป่าหวาย,TH/W_/70,3907,1946,1961,1875
529,ทต.บ้านดอน,TH/CT/72/ทต.บ้านดอน,TH/CT/72,7632,3933,3699,2037
530,ทต.บ้านดู่,TH/N_/57/ทต.บ้านดู่,TH/N_/57,20250,10753,9497,13899
531,ทต.บ้านด่าน,TH/NE/31/ทต.บ้านด่าน,TH/NE/31,12025,6134,5891,3271
532,ทต.บ้านด่านนาขาม,TH/N_/53/ทต.บ้านด่านนาขาม,TH/N_/53,3868,1967,1901,1378
533,ทต.บ้านด่านโขงเจียม,TH/NE/34/ทต.บ้านด่านโขงเจียม,TH/NE/34,2915,1446,1469,1304
534,ทต.บ้านตาก,TH/W_/63/ทต.บ้านตาก,TH/W_/63,6568,3520,3048,2700
535,ทต.บ้านตาขุน,TH/S_/84/ทต.บ้านตาขุน,TH/S_/84,2396,1228,1168,1801
536,ทต.บ้านต้า,TH/N_/57/ทต.บ้านต้า,TH/N_/57,6110,3157,2953,2245
537,ทต.บ้านต๊ำ,TH/N_/56/ทต.บ้านต๊ำ,TH/N_/56,7100,3657,3443,3221
538,ทต.บ้านต๋อม,TH/N_/56/ทต.บ้านต๋อม,TH/N_/56,12590,6793,5797,7205
539,ทต.บ้านถ้ำ,TH/N_/56/ทต.บ้านถ้ำ,TH/N_/56,8247,4083,4164,3180
540,ทต.บ้านท่าหลวง,TH/CT/16/ทต.บ้านท่าหลวง,TH/CT/16,3885,1955,1930,2097
541,ทต.บ้านธาตุ,TH/NE/41/ทต.บ้านธาตุ,TH/NE/41,16920,8585,8335,5103
542,ทต.บ้านธิ,TH/N_/51/ทต.บ้านธิ,TH/N_/51,9486,4961,4525,4289
543,ทต.บ้านนา,TH/E_/21/ทต.บ้านนา,TH/E_/21,8433,4305,4128,3329
544,ทต.บ้านนา,TH/CT/26/ทต.บ้านนา,TH/CT/26,4945,2609,2336,2489
545,ทต.บ้านนา,TH/S_/84/ทต.บ้านนา,TH/S_/84,3284,1699,1585,1638
546,ทต.บ้านนา,TH/S_/93/ทต.บ้านนา,TH/S_/93,7529,3804,3725,3053
547,ทต.บ้านนาปรือ,TH/E_/25/ทต.บ้านนาปรือ,TH/E_/25,2239,1115,1124,783
548,ทต.บ้านนิเวศน์,TH/NE/45/ทต.บ้านนิเวศน์,TH/NE/45,2540,1335,1205,1172
549,ทต.บ้านปลวกแดง,TH/E_/21/ทต.บ้านปลวกแดง,TH/E_/21,5565,2936,2629,4522
550,ทต.บ้านปล้อง,TH/N_/57/ทต.บ้านปล้อง,TH/N_/57,4035,2073,1962,1592
551,ทต.บ้านปิน,TH/N_/54/ทต.บ้านปิน,TH/N_/54,2250,1226,1024,820
552,ทต.บ้านผือ,TH/NE/41/ทต.บ้านผือ,TH/NE/41,7598,3921,3677,4025
553,ทต.บ้านฝาง,TH/NE/ขอนแก่น/ทต.บ้านฝาง,TH/NE/ขอนแก่น,4631,2373,2258,1820
554,ทต.บ้านพราน,TH/CT/62/ทต.บ้านพราน,TH/CT/62,7030,3502,3528,2844
555,ทต.บ้านมุง,TH/CT/65/ทต.บ้านมุง,TH/CT/65,6951,3474,3477,2566
556,ทต.บ้านม่วง,TH/NE/47/ทต.บ้านม่วง,TH/NE/47,3560,1846,1714,1480
557,ทต.บ้านยาง,TH/CT/19/ทต.บ้านยาง,TH/CT/19,1055,572,483,383
558,ทต.บ้านลาด,TH/W_/76/ทต.บ้านลาด,TH/W_/76,3677,1981,1696,1655
559,ทต.บ้านสร้าง,TH/CT/14/ทต.บ้านสร้าง,TH/CT/14,10770,5763,5007,7091
560,ทต.บ้านสร้าง,TH/E_/25/ทต.บ้านสร้าง,TH/E_/25,3249,1654,1595,1616
561,ทต.บ้านสวน,TH/CT/64/ทต.บ้านสวน,TH/CT/64,4374,2301,2073,1703
562,ทต.บ้านสิงห์,TH/W_/70/ทต.บ้านสิงห์,TH/W_/70,12103,6331,5772,4488
563,ทต.บ้านส้อง,TH/S_/84/ทต.บ้านส้อง,TH/S_/84,17645,8907,8738,6817
564,ทต.บ้านหมอ,TH/CT/19/ทต.บ้านหมอ,TH/CT/19,2684,1383,1301,1342
565,ทต.บ้านเกาะ,TH/N_/53/ทต.บ้านเกาะ,TH/N_/53,9131,4848,4283,3756
566,ทต.บ้านเขว้า,TH/NE/36/ทต.บ้านเขว้า,TH/NE/36,8029,4211,3818,3360
567,ทต.บ้านเชียง,TH/NE/41/ทต.บ้านเชียง,TH/NE/41,5949,2987,2962,1960
568,ทต.บ้านเชี่ยวหลาน,TH/S_/84/ทต.บ้านเชี่ยวหลาน,TH/S_/84,4547,2257,2290,1948
569,ทต.บ้านเดื่อ,TH/NE/36/ทต.บ้านเดื่อ,TH/NE/36,15525,7827,7698,4496
570,ทต.บ้านเป็ด,TH/NE/ขอนแก่น/ทต.บ้านเป็ด,TH/NE/ขอนแก่น,45266,24104,21162,26853
571,ทต.บ้านเป้า,TH/NE/36/ทต.บ้านเป้า,TH/NE/36,7722,3936,3786,2329
572,ทต.บ้านเพ,TH/E_/21/ทต.บ้านเพ,TH/E_/21,17769,9308,8461,11923
573,ทต.บ้านเพชร,TH/NE/36/ทต.บ้านเพชร,TH/NE/36,4915,2518,2397,2204
574,ทต.บ้านเพชรภูเขียว,TH/NE/36/ทต.บ้านเพชรภูเขียว,TH/NE/36,5635,2855,2780,1733
575,ทต.บ้านเลือก,TH/W_/70/ทต.บ้านเลือก,TH/W_/70,10754,5613,5141,4948
576,ทต.บ้านเสด็จ,TH/S_/84/ทต.บ้านเสด็จ,TH/S_/84,19298,9521,9777,7725
577,ทต.บ้านเหลื่อม,TH/NE/30/ทต.บ้านเหลื่อม,TH/NE/30,3442,1825,1617,1204
578,ทต.บ้านเหล่า,TH/N_/56/ทต.บ้านเหล่า,TH/N_/56,7834,3989,3845,2938
579,ทต.บ้านเหล่า,TH/N_/57/ทต.บ้านเหล่า,TH/N_/57,4047,2028,2019,1692
580,ทต.บ้านแก่ง,TH/N_/53/ทต.บ้านแก่ง,TH/N_/53,2107,1107,1000,880
581,ทต.บ้านแก้ง,TH/NE/49/ทต.บ้านแก้ง,TH/NE/49,3084,1558,1526,929
582,ทต.บ้านแท่น,TH/NE/36/ทต.บ้านแท่น,TH/NE/36,4067,2076,1991,1614
583,ทต.บ้านแป้น,TH/N_/51/ทต.บ้านแป้น,TH/N_/51,6242,3344,2898,2733
584,ทต.บ้านแพง,TH/NE/48/ทต.บ้านแพง,TH/NE/48,8813,4468,4345,3567
585,ทต.บ้านแพรก,TH/CT/14/ทต.บ้านแพรก,TH/CT/14,2005,1041,964,875
586,ทต.บ้านแพ้ว,TH/CT/74/ทต.บ้านแพ้ว,TH/CT/74,3207,1669,1538,1056
587,ทต.บ้านแม่ข่า,TH/N_/เชียงใหม่/ทต.บ้านแม่ข่า,TH/N_/เชียงใหม่,1913,971,942,889
588,ทต.บ้านแยง,TH/CT/65/ทต.บ้านแยง,TH/CT/65,9935,4883,5052,4877
589,ทต.บ้านแหลม,TH/CT/72/ทต.บ้านแหลม,TH/CT/72,1198,602,596,446
590,ทต.บ้านแหลม,TH/W_/76/ทต.บ้านแหลม,TH/W_/76,11731,6080,5651,4212
591,ทต.บ้านแฮด,TH/NE/ขอนแก่น/ทต.บ้านแฮด,TH/NE/ขอนแก่น,6703,3392,3311,2234
592,ทต.บ้านโข้ง,TH/CT/72/ทต.บ้านโข้ง,TH/CT/72,9025,4580,4445,2998
593,ทต.บ้านโคก,TH/NE/39/ทต.บ้านโคก,TH/NE/39,6300,3297,3003,1865
594,ทต.บ้านโคก,TH/N_/53/ทต.บ้านโคก,TH/N_/53,3870,1922,1948,1876
595,ทต.บ้านโคก,TH/NE/ขอนแก่น/ทต.บ้านโคก,TH/NE/ขอนแก่น,4127,2143,1984,1424
596,ทต.บ้านโตนด,TH/CT/64/ทต.บ้านโตนด,TH/CT/64,3032,1607,1425,1602
597,ทต.บ้านโต้น,TH/NE/ขอนแก่น/ทต.บ้านโต้น,TH/NE/ขอนแก่น,6510,3380,3130,2013
598,ทต.บ้านโพธิ์,TH/E_/24/ทต.บ้านโพธิ์,TH/E_/24,2833,1441,1392,1409
599,ทต.บ้านโฮ่ง,TH/N_/51/ทต.บ้านโฮ่ง,TH/N_/51,7700,4142,3558,3607
600,ทต.บ้านใหม่,TH/N_/52/ทต.บ้านใหม่,TH/N_/52,2570,1286,1284,879
601,ทต.บ้านใหม่,TH/CT/65/ทต.บ้านใหม่,TH/CT/65,1935,1019,916,790
602,ทต.บ้านใหม่ไชยพจน์,TH/NE/31/ทต.บ้านใหม่ไชยพจน์,TH/NE/31,4303,2198,2105,1405
603,ทต.บ้านไร่,TH/CT/61/ทต.บ้านไร่,TH/CT/61,2551,1300,1251,1391
604,ทต.บ้านไร่,TH/S_/90/ทต.บ้านไร่,TH/S_/90,8035,4104,3931,3384
605,ทต.ปง,TH/N_/56/ทต.ปง,TH/N_/56,5656,2966,2690,2800
606,ทต.ปทุม,TH/NE/34/ทต.ปทุม,TH/NE/34,10535,5540,4995,4099
607,ทต.ปทุมรัตต์,TH/NE/45/ทต.ปทุมรัตต์,TH/NE/45,6361,3288,3073,2116
608,ทต.ปทุมราชวงศา,TH/NE/37/ทต.ปทุมราชวงศา,TH/NE/37,3482,1760,1722,1694
609,ทต.ประจันตคาม,TH/E_/25/ทต.ประจันตคาม,TH/E_/25,4536,2388,2148,2367
610,ทต.ประทาย,TH/NE/30/ทต.ประทาย,TH/NE/30,6098,3138,2960,3041
611,ทต.ประโคนชัย,TH/NE/31/ทต.ประโคนชัย,TH/NE/31,9650,5092,4558,4083
612,ทต.ปรางค์กู่,TH/NE/33/ทต.ปรางค์กู่,TH/NE/33,2738,1399,1339,1204
613,ทต.ปราณบุรี,TH/W_/ประจวบคีรีขันธ์/ทต.ปราณบุรี,TH/W_/ประจวบคีรีขันธ์,16616,8674,7942,9308
614,ทต.ปราสาททอง,TH/CT/14/ทต.ปราสาททอง,TH/CT/14,4642,2438,2204,2996
615,ทต.ปริก,TH/S_/90/ทต.ปริก,TH/S_/90,6370,3251,3119,2011
616,ทต.ปรุใหญ่,TH/NE/30/ทต.ปรุใหญ่,TH/NE/30,9840,5134,4706,5106
617,ทต.ปลักแรด,TH/CT/65/ทต.ปลักแรด,TH/CT/65,3574,1875,1699,1303
618,ทต.ปลาปาก,TH/NE/48/ทต.ปลาปาก,TH/NE/48,3929,2020,1909,1566
619,ทต.ปลายนา,TH/CT/72/ทต.ปลายนา,TH/CT/72,8315,4333,3982,2873
620,ทต.ปลายบาง,TH/CT/12/ทต.ปลายบาง,TH/CT/12,46355,25017,21338,23299
621,ทต.ปลายพระยา,TH/S_/81/ทต.ปลายพระยา,TH/S_/81,6059,3023,3036,2478
622,ทต.ปอภาร,TH/NE/45/ทต.ปอภาร,TH/NE/45,7274,3793,3481,2421
623,ทต.ปะคำ,TH/NE/31/ทต.ปะคำ,TH/NE/31,7130,3613,3517,2730
624,ทต.ปะทิว,TH/S_/86/ทต.ปะทิว,TH/S_/86,1371,736,635,874
625,ทต.ปะนาเระ,TH/S_/94/ทต.ปะนาเระ,TH/S_/94,10549,5246,5303,2642
626,ทต.ปะลุรู,TH/S_/96/ทต.ปะลุรู,TH/S_/96,7063,3588,3475,2085
627,ทต.ปะโค,TH/NE/41/ทต.ปะโค,TH/NE/41,11287,5650,5637,3398
628,ทต.ปัว,TH/N_/55/ทต.ปัว,TH/N_/55,10453,5408,5045,4844
629,ทต.ปากคาด,TH/NE/38/ทต.ปากคาด,TH/NE/38,6699,3344,3355,2701
630,ทต.ปากชม,TH/NE/42/ทต.ปากชม,TH/NE/42,3467,1780,1687,1540
631,ทต.ปากดง,TH/CT/62/ทต.ปากดง,TH/CT/62,3273,1706,1567,1324
632,ทต.ปากตะโก,TH/S_/86/ทต.ปากตะโก,TH/S_/86,4098,2014,2084,1621
633,ทต.ปากท่อ,TH/W_/70/ทต.ปากท่อ,TH/W_/70,2852,1471,1381,1389
634,ทต.ปากนคร,TH/S_/นครศรีธรรมราช/ทต.ปากนคร,TH/S_/นครศรีธรรมราช,6296,3129,3167,2000
635,ทต.ปากน้ำ,TH/E_/24/ทต.ปากน้ำ,TH/E_/24,5556,2896,2660,2579
636,ทต.ปากน้ำ,TH/CT/72/ทต.ปากน้ำ,TH/CT/72,4514,2361,2153,1758
637,ทต.ปากน้ำ,TH/S_/85/ทต.ปากน้ำ,TH/S_/85,2553,1210,1343,1753
638,ทต.ปากน้ำชุมพร,TH/S_/86/ทต.ปากน้ำชุมพร,TH/S_/86,6441,3297,3144,3400
639,ทต.ปากน้ำประแส,TH/E_/21/ทต.ปากน้ำประแส,TH/E_/21,4809,2489,2320,1978
640,ทต.ปากน้ำปราณ,TH/W_/ประจวบคีรีขันธ์/ทต.ปากน้ำปราณ,TH/W_/ประจวบคีรีขันธ์,7835,3904,3931,3463
641,ทต.ปากน้ำหลังสวน,TH/S_/86/ทต.ปากน้ำหลังสวน,TH/S_/86,6514,3293,3221,3039
642,ทต.ปากน้ำแหลมสิงห์,TH/E_/22/ทต.ปากน้ำแหลมสิงห์,TH/E_/22,8796,4515,4281,3406
643,ทต.ปากพะยูน,TH/S_/93/ทต.ปากพะยูน,TH/S_/93,3283,1707,1576,1523
644,ทต.ปาย,TH/N_/58/ทต.ปาย,TH/N_/58,3598,1845,1753,1890
645,ทต.ปิงโค้ง,TH/N_/เชียงใหม่/ทต.ปิงโค้ง,TH/N_/เชียงใหม่,14007,6452,7555,4468
646,ทต.ป่ากุมเกาะ,TH/CT/64/ทต.ป่ากุมเกาะ,TH/CT/64,7743,4017,3726,2767
647,ทต.ป่าก่อดำ,TH/N_/57/ทต.ป่าก่อดำ,TH/N_/57,4240,2214,2026,1989
648,ทต.ป่าซาง,TH/N_/51/ทต.ป่าซาง,TH/N_/51,8487,4585,3902,4141
649,ทต.ป่าซาง,TH/N_/57/ทต.ป่าซาง,TH/N_/57,11601,6132,5469,5548
650,ทต.ป่าตันนาครัว,TH/N_/52/ทต.ป่าตันนาครัว,TH/N_/52,7865,4063,3802,2967
651,ทต.ป่าติ้ว,TH/NE/35/ทต.ป่าติ้ว,TH/NE/35,3074,1563,1511,1209
652,ทต.ป่าบอน,TH/S_/93/ทต.ป่าบอน,TH/S_/93,3921,1989,1932,1714
653,ทต.ป่าอ้อดอนชัย,TH/N_/57/ทต.ป่าอ้อดอนชัย,TH/N_/57,11363,6010,5353,5324
654,ทต.ป่าแงะ,TH/N_/57/ทต.ป่าแงะ,TH/N_/57,7623,3879,3744,3047
655,ทต.ป่าแดง,TH/CT/65/ทต.ป่าแดง,TH/CT/65,5356,2737,2619,2564
656,ทต.ป่าแดด,TH/N_/57/ทต.ป่าแดด,TH/N_/57,6357,3248,3109,2408
657,ทต.ป่าแดด,TH/N_/เชียงใหม่/ทต.ป่าแดด,TH/N_/เชียงใหม่,17567,9471,8096,10832
658,ทต.ป่าแมต,TH/N_/54/ทต.ป่าแมต,TH/N_/54,12043,6405,5638,4899
659,ทต.ป่าโมก,TH/CT/15/ทต.ป่าโมก,TH/CT/15,8898,4622,4276,3593
660,ทต.ป่าไผ่,TH/N_/เชียงใหม่/ทต.ป่าไผ่,TH/N_/เชียงใหม่,13651,7178,6473,6053
661,ทต.ป๊อกแป๊ก,TH/CT/19/ทต.ป๊อกแป๊ก,TH/CT/19,721,386,335,412
662,ทต.ผาจุก,TH/N_/53/ทต.ผาจุก,TH/N_/53,8093,4164,3929,3029
663,ทต.ผาสุก,TH/NE/41/ทต.ผาสุก,TH/NE/41,15841,7770,8071,4714
664,ทต.ฝายกวาง,TH/N_/56/ทต.ฝายกวาง,TH/N_/56,8838,4543,4295,3756
665,ทต.พญาเม็งราย,TH/N_/57/ทต.พญาเม็งราย,TH/N_/57,4217,2193,2024,2209
666,ทต.พนม,TH/S_/84/ทต.พนม,TH/S_/84,4930,2450,2480,1982
667,ทต.พนมทวน,TH/W_/71/ทต.พนมทวน,TH/W_/71,5226,2756,2470,2179
668,ทต.พนมรุ้ง,TH/NE/31/ทต.พนมรุ้ง,TH/NE/31,11836,6107,5729,3849
669,ทต.พนมสารคาม,TH/E_/24/ทต.พนมสารคาม,TH/E_/24,6457,3465,2992,4216
670,ทต.พนมไพร,TH/NE/45/ทต.พนมไพร,TH/NE/45,4181,2139,2042,1770
671,ทต.พนา,TH/NE/37/ทต.พนา,TH/NE/37,2734,1441,1293,1104
672,ทต.พบพระ,TH/W_/63/ทต.พบพระ,TH/W_/63,6350,3075,3275,2702
673,ทต.พยัคฆภูมิพิสัย,TH/NE/44/ทต.พยัคฆภูมิพิสัย,TH/NE/44,8040,4220,3820,4178
674,ทต.พยุหะ,TH/CT/60/ทต.พยุหะ,TH/CT/60,5611,3010,2601,2965
675,ทต.พยุห์,TH/NE/33/ทต.พยุห์,TH/NE/33,3914,1973,1941,1401
676,ทต.พรรณานิคม,TH/NE/47/ทต.พรรณานิคม,TH/NE/47,2433,1286,1147,1448
677,ทต.พรหมบุรี,TH/CT/17/ทต.พรหมบุรี,TH/CT/17,3173,1645,1528,1301
678,ทต.พรหมพิราม,TH/CT/65/ทต.พรหมพิราม,TH/CT/65,1127,599,528,544
679,ทต.พรหมโลก,TH/S_/นครศรีธรรมราช/ทต.พรหมโลก,TH/S_/นครศรีธรรมราช,6789,3440,3349,2677
680,ทต.พระทองคำ,TH/NE/30/ทต.พระทองคำ,TH/NE/30,4084,2085,1999,1637
681,ทต.พระธาตุปู่ก่ำ,TH/N_/เชียงใหม่/ทต.พระธาตุปู่ก่ำ,TH/N_/เชียงใหม่,2352,1195,1157,1103
682,ทต.พระยืน,TH/NE/ขอนแก่น/ทต.พระยืน,TH/NE/ขอนแก่น,3316,1730,1586,1455
683,ทต.พระสมุทรเจดีย์,TH/CT/11/ทต.พระสมุทรเจดีย์,TH/CT/11,12081,6150,5931,5697
684,ทต.พระอินทราชา,TH/CT/14/ทต.พระอินทราชา,TH/CT/14,9439,4949,4490,6309
685,ทต.พระเหลา,TH/NE/37/ทต.พระเหลา,TH/NE/37,6056,3037,3019,2144
686,ทต.พระแท่น,TH/W_/71/ทต.พระแท่น,TH/W_/71,6179,3219,2960,2118
687,ทต.พรานกระต่าย,TH/CT/62/ทต.พรานกระต่าย,TH/CT/62,8746,4559,4187,3667
688,ทต.พรเจริญ,TH/NE/38/ทต.พรเจริญ,TH/NE/38,10335,5279,5056,3484
689,ทต.พลวง,TH/E_/22/ทต.พลวง,TH/E_/22,7517,3897,3620,4128
690,ทต.พลับพลาชัย,TH/NE/31/ทต.พลับพลาชัย,TH/NE/31,6626,3276,3350,1938
691,ทต.พลับพลานารายณ์,TH/E_/22/ทต.พลับพลานารายณ์,TH/E_/22,10386,5466,4920,6199
692,ทต.พลา,TH/E_/21/ทต.พลา,TH/E_/21,9218,4607,4611,5885
693,ทต.พลายชุมพล,TH/CT/65/ทต.พลายชุมพล,TH/CT/65,7567,4043,3524,4165
694,ทต.พลิ้ว,TH/E_/22/ทต.พลิ้ว,TH/E_/22,7076,3756,3320,3086
695,ทต.พะตง,TH/S_/90/ทต.พะตง,TH/S_/90,7726,4101,3625,4737
696,ทต.พะวง,TH/S_/90/ทต.พะวง,TH/S_/90,33923,17693,16230,15176
697,ทต.พะโต๊ะ,TH/S_/86/ทต.พะโต๊ะ,TH/S_/86,1480,741,739,687
698,ทต.พังโคน,TH/NE/47/ทต.พังโคน,TH/NE/47,6474,3280,3194,3935
699,ทต.พัฒนานิคม,TH/CT/16/ทต.พัฒนานิคม,TH/CT/16,3294,1723,1571,1436
700,ทต.พันดอน,TH/NE/41/ทต.พันดอน,TH/NE/41,5567,2925,2642,2599
701,ทต.พันเสา,TH/CT/65/ทต.พันเสา,TH/CT/65,6080,3074,3006,2072
702,ทต.พานทอง,TH/E_/ชลบุรี/ทต.พานทอง,TH/E_/ชลบุรี,6274,3257,3017,3745
703,ทต.พิปูน,TH/S_/นครศรีธรรมราช/ทต.พิปูน,TH/S_/นครศรีธรรมราช,2729,1412,1317,1123
704,ทต.พิมพา,TH/E_/24/ทต.พิมพา,TH/E_/24,3375,1747,1628,3428
705,ทต.พิมาย,TH/NE/30/ทต.พิมาย,TH/NE/30,7877,4232,3645,2888
706,ทต.พุกร่าง,TH/CT/19/ทต.พุกร่าง,TH/CT/19,6768,3463,3305,2396
707,ทต.พุทไธสง,TH/NE/31/ทต.พุทไธสง,TH/NE/31,4252,2225,2027,2239
708,ทต.พุมเรียง,TH/S_/84/ทต.พุมเรียง,TH/S_/84,7878,4034,3844,2713
709,ทต.พุเตย,TH/CT/67/ทต.พุเตย,TH/CT/67,7386,3773,3613,3013
710,ทต.ฟากท่า,TH/N_/53/ทต.ฟากท่า,TH/N_/53,725,349,376,425
711,ทต.ฟ้าหยาด,TH/NE/35/ทต.ฟ้าหยาด,TH/NE/35,4751,2429,2322,1842
712,ทต.ฟ้าฮ่าม,TH/N_/เชียงใหม่/ทต.ฟ้าฮ่าม,TH/N_/เชียงใหม่,6965,3728,3237,9486
713,ทต.ภาชี,TH/CT/14/ทต.ภาชี,TH/CT/14,5365,2838,2527,2543
714,ทต.ภูกระดึง,TH/NE/42/ทต.ภูกระดึง,TH/NE/42,7237,3640,3597,2729
715,ทต.ภูผาม่าน,TH/NE/ขอนแก่น/ทต.ภูผาม่าน,TH/NE/ขอนแก่น,3488,1787,1701,1276
716,ทต.ภูผาแดง,TH/NE/41/ทต.ภูผาแดง,TH/NE/41,8143,4169,3974,2338
717,ทต.ภูสิงห์,TH/NE/46/ทต.ภูสิงห์,TH/NE/46,2793,1368,1425,819
718,ทต.ภูเขียว,TH/NE/36/ทต.ภูเขียว,TH/NE/36,6252,3343,2909,3015
719,ทต.ภูเรือ,TH/NE/42/ทต.ภูเรือ,TH/NE/42,2869,1413,1456,1573
720,ทต.ภูเวียง,TH/NE/ขอนแก่น/ทต.ภูเวียง,TH/NE/ขอนแก่น,2999,1564,1435,1728
721,ทต.มวกเหล็ก,TH/CT/19/ทต.มวกเหล็ก,TH/CT/19,6870,3537,3333,3761
722,ทต.มหาพราหมณ์,TH/CT/14/ทต.มหาพราหมณ์,TH/CT/14,8484,4405,4079,3254
723,ทต.มหาราช,TH/CT/14/ทต.มหาราช,TH/CT/14,3231,1664,1567,1437
724,ทต.มะกอก,TH/N_/51/ทต.มะกอก,TH/N_/51,5200,2745,2455,2342
725,ทต.มะกอกเหนือ,TH/S_/93/ทต.มะกอกเหนือ,TH/S_/93,2152,1170,982,790
726,ทต.มะขาม,TH/E_/22/ทต.มะขาม,TH/E_/22,1722,914,808,1025
727,ทต.มะขามคู่,TH/E_/21/ทต.มะขามคู่,TH/E_/21,13578,6872,6706,11623
728,ทต.มะค่า,TH/NE/30/ทต.มะค่า,TH/NE/30,1937,981,956,586
729,ทต.มะรือโบตก,TH/S_/96/ทต.มะรือโบตก,TH/S_/96,8423,4181,4242,1758
730,ทต.มะอึ,TH/NE/45/ทต.มะอึ,TH/NE/45,5337,2747,2590,2120
731,ทต.มะเขือแจ้,TH/N_/51/ทต.มะเขือแจ้,TH/N_/51,15954,8322,7632,8579
732,ทต.มัญจาคีรี,TH/NE/ขอนแก่น/ทต.มัญจาคีรี,TH/NE/ขอนแก่น,3614,1906,1708,1919
733,ทต.มาบข่า,TH/E_/21/ทต.มาบข่า,TH/E_/21,10622,5313,5309,8035
734,ทต.มาบข่าพัฒนา,TH/E_/21/ทต.มาบข่าพัฒนา,TH/E_/21,9448,4760,4688,6773
735,ทต.มาบอำมฤต,TH/S_/86/ทต.มาบอำมฤต,TH/S_/86,3739,1907,1832,2181
736,ทต.มายอ,TH/S_/94/ทต.มายอ,TH/S_/94,4837,2420,2417,1194
737,ทต.ม่วงน้อย,TH/N_/51/ทต.ม่วงน้อย,TH/N_/51,4232,2269,1963,1984
738,ทต.ม่วงสามสิบ,TH/NE/34/ทต.ม่วงสามสิบ,TH/NE/34,3133,1637,1496,1586
739,ทต.ม่วงหวาน,TH/NE/ขอนแก่น/ทต.ม่วงหวาน,TH/NE/ขอนแก่น,10254,5195,5059,3491
740,ทต.ยะรัง,TH/S_/94/ทต.ยะรัง,TH/S_/94,5044,2578,2466,1337
741,ทต.ยะหริ่ง,TH/S_/94/ทต.ยะหริ่ง,TH/S_/94,6254,3068,3186,1916
742,ทต.ยะหา,TH/S_/95/ทต.ยะหา,TH/S_/95,2478,1220,1258,759
743,ทต.ยางชุมน้อย,TH/NE/33/ทต.ยางชุมน้อย,TH/NE/33,6334,3207,3127,2387
744,ทต.ยางตลาด,TH/NE/46/ทต.ยางตลาด,TH/NE/46,8553,4478,4075,3780
745,ทต.ยางหล่อ,TH/NE/39/ทต.ยางหล่อ,TH/NE/39,9273,4673,4600,2557
746,ทต.ยางฮอม,TH/N_/57/ทต.ยางฮอม,TH/N_/57,11039,5629,5410,4003
747,ทต.ยางเนิ้ง,TH/N_/เชียงใหม่/ทต.ยางเนิ้ง,TH/N_/เชียงใหม่,10381,5658,4723,5388
748,ทต.ยายแย้มวัฒนา,TH/NE/31/ทต.ยายแย้มวัฒนา,TH/NE/31,8642,4300,4342,2316
749,ทต.ยี่งอ,TH/S_/96/ทต.ยี่งอ,TH/S_/96,3057,1537,1520,1086
750,ทต.ย่านดินแดง,TH/S_/84/ทต.ย่านดินแดง,TH/S_/84,2475,1258,1217,1077
751,ทต.ย่านตาขาว,TH/S_/92/ทต.ย่านตาขาว,TH/S_/92,7764,4176,3588,3794
752,ทต.ระหาน,TH/CT/62/ทต.ระหาน,TH/CT/62,7274,3701,3573,3545
753,ทต.ระแหง,TH/CT/ปทุมธานี/ทต.ระแหง,TH/CT/ปทุมธานี,10415,5429,4986,5245
754,ทต.ระโนด,TH/S_/90/ทต.ระโนด,TH/S_/90,4541,2364,2177,1946
755,ทต.รัตนบุรี,TH/S_/32/ทต.รัตนบุรี,TH/S_/32,5396,2798,2598,2681
756,ทต.รัษฎา,TH/S_/83/ทต.รัษฎา,TH/S_/83,48696,25635,23061,30382
757,ทต.รางกระทุ่ม,TH/CT/73/ทต.รางกระทุ่ม,TH/CT/73,2121,1103,1018,683
758,ทต.รางหวาย,TH/W_/71/ทต.รางหวาย,TH/W_/71,7260,3623,3637,2567
759,ทต.ราชคราม,TH/CT/14/ทต.ราชคราม,TH/CT/14,6010,3010,3000,1804
760,ทต.ราไวย์,TH/S_/83/ทต.ราไวย์,TH/S_/83,18760,9962,8798,19219
761,ทต.รำมะสัก,TH/CT/15/ทต.รำมะสัก,TH/CT/15,4219,2210,2009,1561
762,ทต.ริมปิง,TH/N_/51/ทต.ริมปิง,TH/N_/51,6779,3602,3177,2898
763,ทต.รือเสาะ,TH/S_/96/ทต.รือเสาะ,TH/S_/96,7537,3825,3712,3509
764,ทต.ร่มเกล้า,TH/NE/49/ทต.ร่มเกล้า,TH/NE/49,3343,1636,1707,1059
765,ทต.ร่วมจิต,TH/N_/53/ทต.ร่วมจิต,TH/N_/53,3386,1788,1598,1198
766,ทต.ร่องคำ,TH/NE/46/ทต.ร่องคำ,TH/NE/46,6074,3102,2972,2169
767,ทต.ร่อนทอง,TH/W_/ประจวบคีรีขันธ์/ทต.ร่อนทอง,TH/W_/ประจวบคีรีขันธ์,7864,3984,3880,3359
768,ทต.ร่อนพิบูลย์,TH/S_/นครศรีธรรมราช/ทต.ร่อนพิบูลย์,TH/S_/นครศรีธรรมราช,7685,4013,3672,3303
769,ทต.ร้องกวาง,TH/N_/54/ทต.ร้องกวาง,TH/N_/54,12455,6549,5906,6031
770,ทต.ละหานทราย,TH/NE/31/ทต.ละหานทราย,TH/NE/31,8300,4131,4169,3379
771,ทต.ละอุ่น,TH/S_/85/ทต.ละอุ่น,TH/S_/85,2671,1315,1356,1195
772,ทต.ละแม,TH/S_/86/ทต.ละแม,TH/S_/86,3075,1592,1483,1815
773,ทต.ลาดชะโด,TH/CT/14/ทต.ลาดชะโด,TH/CT/14,7650,3947,3703,2754
774,ทต.ลาดบัวขาว,TH/NE/30/ทต.ลาดบัวขาว,TH/NE/30,4156,2181,1975,2204
775,ทต.ลาดบัวหลวง,TH/CT/14/ทต.ลาดบัวหลวง,TH/CT/14,2651,1351,1300,1414
776,ทต.ลาดยาว,TH/CT/60/ทต.ลาดยาว,TH/CT/60,6049,3206,2843,3478
777,ทต.ลาดหญ้า,TH/W_/71/ทต.ลาดหญ้า,TH/W_/71,5488,2833,2655,2324
778,ทต.ลาดใหญ่,TH/NE/36/ทต.ลาดใหญ่,TH/NE/36,4584,2419,2165,1736
779,ทต.ลานกระบือ,TH/CT/62/ทต.ลานกระบือ,TH/CT/62,4284,2166,2118,2492
780,ทต.ลานข่อย,TH/S_/93/ทต.ลานข่อย,TH/S_/93,8679,4453,4226,2909
781,ทต.ลานสกา,TH/S_/นครศรีธรรมราช/ทต.ลานสกา,TH/S_/นครศรีธรรมราช,1776,907,869,1011
782,ทต.ลานสัก,TH/CT/61/ทต.ลานสัก,TH/CT/61,3417,1728,1689,2126
783,ทต.ลานหอย,TH/CT/64/ทต.ลานหอย,TH/CT/64,3602,1869,1733,1707
784,ทต.ลำคลอง,TH/NE/46/ทต.ลำคลอง,TH/NE/46,4265,2203,2062,1324
785,ทต.ลำดวนสุรพินท์,TH/S_/32/ทต.ลำดวนสุรพินท์,TH/S_/32,4345,2259,2086,1852
786,ทต.ลำทับ,TH/S_/81/ทต.ลำทับ,TH/S_/81,4305,2219,2086,2370
787,ทต.ลำนางแก้ว,TH/NE/30/ทต.ลำนางแก้ว,TH/NE/30,4756,2391,2365,1373
788,ทต.ลำนารายณ์,TH/CT/16/ทต.ลำนารายณ์,TH/CT/16,15883,8236,7647,8564
789,ทต.ลำปลายมาศ,TH/NE/31/ทต.ลำปลายมาศ,TH/NE/31,13358,6938,6420,6141
790,ทต.ลำปางหลวง,TH/N_/52/ทต.ลำปางหลวง,TH/N_/52,9245,4833,4412,3321
791,ทต.ลำพญา,TH/CT/73/ทต.ลำพญา,TH/CT/73,1921,1000,921,624
792,ทต.ลำพันชาด,TH/NE/41/ทต.ลำพันชาด,TH/NE/41,5579,2758,2821,1984
793,ทต.ลำภูรา,TH/S_/92/ทต.ลำภูรา,TH/S_/92,3445,1465,1980,1489
794,ทต.ลำลูกกา,TH/CT/ปทุมธานี/ทต.ลำลูกกา,TH/CT/ปทุมธานี,19109,10030,9079,10044
795,ทต.ลำใหม่,TH/S_/95/ทต.ลำใหม่,TH/S_/95,991,496,495,378
796,ทต.ลำไทร,TH/CT/ปทุมธานี/ทต.ลำไทร,TH/CT/ปทุมธานี,2616,1328,1288,1043
797,ทต.ลำไพล,TH/S_/90/ทต.ลำไพล,TH/S_/90,15870,8011,7859,4572
798,ทต.ลูกแก,TH/W_/71/ทต.ลูกแก,TH/W_/71,3593,1924,1669,1510
799,ทต.วงฆ้อง,TH/CT/65/ทต.วงฆ้อง,TH/CT/65,3155,1611,1544,1545
800,ทต.วังกรด,TH/CT/66/ทต.วังกรด,TH/CT/66,3014,1520,1494,1045
801,ทต.วังกะ,TH/W_/71/ทต.วังกะ,TH/W_/71,9218,4535,4683,2553
802,ทต.วังกะพี้,TH/N_/53/ทต.วังกะพี้,TH/N_/53,9678,5148,4530,3397
803,ทต.วังขนาย,TH/W_/71/ทต.วังขนาย,TH/W_/71,9122,4768,4354,3843
804,ทต.วังชมภู,TH/CT/67/ทต.วังชมภู,TH/CT/67,3555,1886,1669,1317
805,ทต.วังชัย,TH/NE/ขอนแก่น/ทต.วังชัย,TH/NE/ขอนแก่น,6436,3327,3109,2871
806,ทต.วังชิ้น,TH/N_/54/ทต.วังชิ้น,TH/N_/54,2942,1507,1435,1417
807,ทต.วังดิน,TH/N_/51/ทต.วังดิน,TH/N_/51,4343,2250,2093,2701
808,ทต.วังตะกู,TH/CT/66/ทต.วังตะกู,TH/CT/66,1629,809,820,648
809,ทต.วังตะเคียน,TH/CT/18/ทต.วังตะเคียน,TH/CT/18,6688,3415,3273,2458
810,ทต.วังทรายพูน,TH/CT/66/ทต.วังทรายพูน,TH/CT/66,3300,1683,1617,1224
811,ทต.วังทอง,TH/CT/65/ทต.วังทอง,TH/CT/65,4345,2305,2040,1713
812,ทต.วังผาง,TH/N_/51/ทต.วังผาง,TH/N_/51,7688,4062,3626,3237
813,ทต.วังม่วง,TH/CT/19/ทต.วังม่วง,TH/CT/19,4288,2197,2091,2550
814,ทต.วังยาง,TH/CT/62/ทต.วังยาง,TH/CT/62,5489,2784,2705,2112
815,ทต.วังยาง,TH/CT/72/ทต.วังยาง,TH/CT/72,6920,3636,3284,2724
816,ทต.วังวิเศษ,TH/S_/92/ทต.วังวิเศษ,TH/S_/92,3020,1534,1486,1320
817,ทต.วังศาลา,TH/W_/71/ทต.วังศาลา,TH/W_/71,11848,6090,5758,5126
818,ทต.วังสมบูรณ์,TH/E_/27/ทต.วังสมบูรณ์,TH/E_/27,10720,5434,5286,5020
819,ทต.วังสามหมอ,TH/NE/41/ทต.วังสามหมอ,TH/NE/41,6005,3072,2933,2798
820,ทต.วังเจ้า,TH/W_/63/ทต.วังเจ้า,TH/W_/63,4238,2133,2105,1933
821,ทต.วังเย็น,TH/E_/24/ทต.วังเย็น,TH/E_/24,9229,4678,4551,3234
822,ทต.วังเหนือ,TH/N_/52/ทต.วังเหนือ,TH/N_/52,4048,2013,2035,1958
823,ทต.วังโป่ง,TH/CT/67/ทต.วังโป่ง,TH/CT/67,3867,2025,1842,1494
824,ทต.วังโพธิ์,TH/W_/71/ทต.วังโพธิ์,TH/W_/71,2077,1007,1070,883
825,ทต.วังไทร,TH/NE/30/ทต.วังไทร,TH/NE/30,11431,5804,5627,4986
826,ทต.วังไผ่,TH/S_/86/ทต.วังไผ่,TH/S_/86,6720,3525,3195,4604
827,ทต.วัฒนานคร,TH/E_/27/ทต.วัฒนานคร,TH/E_/27,5804,3104,2700,3038
828,ทต.วัดประดู่,TH/S_/84/ทต.วัดประดู่,TH/S_/84,18613,9765,8848,10822
829,ทต.วัดสิงห์,TH/CT/18/ทต.วัดสิงห์,TH/CT/18,3214,1698,1516,1968
830,ทต.วัดเพลง,TH/W_/70/ทต.วัดเพลง,TH/W_/70,1382,716,666,562
831,ทต.วัดโบสถ์,TH/CT/65/ทต.วัดโบสถ์,TH/CT/65,8031,4229,3802,3958
832,ทต.วานรนิวาส,TH/NE/47/ทต.วานรนิวาส,TH/NE/47,5864,3091,2773,2370
833,ทต.วาปีปทุม,TH/NE/44/ทต.วาปีปทุม,TH/NE/44,4760,2492,2268,2352
834,ทต.วาริชภูมิ,TH/NE/47/ทต.วาริชภูมิ,TH/NE/47,2858,1462,1396,1335
835,ทต.วิชิต,TH/S_/83/ทต.วิชิต,TH/S_/83,52283,27812,24471,34698
836,ทต.วิหารแดง,TH/CT/19/ทต.วิหารแดง,TH/CT/19,4164,2200,1964,1892
837,ทต.วิเศษไชยชาญ,TH/CT/15/ทต.วิเศษไชยชาญ,TH/CT/15,5982,3233,2749,2988
838,ทต.ศรีดอนไผ่,TH/W_/70/ทต.ศรีดอนไผ่,TH/W_/70,10741,5633,5108,3388
839,ทต.ศรีธาตุ,TH/NE/41/ทต.ศรีธาตุ,TH/NE/41,5433,2750,2683,1880
840,ทต.ศรีนคร,TH/CT/64/ทต.ศรีนคร,TH/CT/64,3088,1648,1440,1677
841,ทต.ศรีประจันต์,TH/CT/72/ทต.ศรีประจันต์,TH/CT/72,5741,3052,2689,2596
842,ทต.ศรีพนมมาศ,TH/N_/53/ทต.ศรีพนมมาศ,TH/N_/53,3001,1625,1376,1195
843,ทต.ศรีพนา,TH/NE/38/ทต.ศรีพนา,TH/NE/38,6635,3330,3305,2664
844,ทต.ศรีมหาโพธิ,TH/E_/25/ทต.ศรีมหาโพธิ,TH/E_/25,3639,1873,1766,2408
845,ทต.ศรีรัตนะ,TH/NE/33/ทต.ศรีรัตนะ,TH/NE/33,4714,2387,2327,1454
846,ทต.ศรีวิไล,TH/NE/38/ทต.ศรีวิไล,TH/NE/38,11090,5551,5539,3835
847,ทต.ศรีสงคราม,TH/NE/48/ทต.ศรีสงคราม,TH/NE/48,5061,2588,2473,2477
848,ทต.ศรีสาคร,TH/S_/96/ทต.ศรีสาคร,TH/S_/96,5081,2500,2581,1770
849,ทต.ศรีสำโรง,TH/CT/64/ทต.ศรีสำโรง,TH/CT/64,7287,3902,3385,3463
850,ทต.ศรีเชียงใหม่,TH/NE/43/ทต.ศรีเชียงใหม่,TH/NE/43,6425,3267,3158,2793
851,ทต.ศรีเตี้ย,TH/N_/51/ทต.ศรีเตี้ย,TH/N_/51,5499,2851,2648,2221
852,ทต.ศรีเมืองใหม่,TH/NE/34/ทต.ศรีเมืองใหม่,TH/NE/34,4200,2103,2097,1908
853,ทต.ศาลากลาง,TH/CT/12/ทต.ศาลากลาง,TH/CT/12,20057,10781,9276,10742
854,ทต.ศาลายา,TH/CT/73/ทต.ศาลายา,TH/CT/73,11254,5284,5970,7650
855,ทต.ศาลาลำดวน,TH/E_/27/ทต.ศาลาลำดวน,TH/E_/27,2611,1325,1286,1186
856,ทต.ศาลาแดง,TH/E_/24/ทต.ศาลาแดง,TH/E_/24,1469,760,709,522
857,ทต.ศาลเจ้าพ่อ,TH/NE/30/ทต.ศาลเจ้าพ่อ,TH/NE/30,1933,1023,910,950
858,ทต.ศาลเจ้าพ่อขุนศรี,TH/NE/31/ทต.ศาลเจ้าพ่อขุนศรี,TH/NE/31,3368,1700,1668,1273
859,ทต.ศาลเจ้าไก่ต่อ,TH/CT/60/ทต.ศาลเจ้าไก่ต่อ,TH/CT/60,3318,1756,1562,1444
860,ทต.ศีขรภูมิ,TH/S_/32/ทต.ศีขรภูมิ,TH/S_/32,4695,2454,2241,2782
861,ทต.สตึก,TH/NE/31/ทต.สตึก,TH/NE/31,11017,5698,5319,5570
862,ทต.สทิงพระ,TH/S_/90/ทต.สทิงพระ,TH/S_/90,2782,1467,1315,1290
863,ทต.สนม,TH/S_/32/ทต.สนม,TH/S_/32,5029,2576,2453,1589
864,ทต.สนามชัยเขต,TH/E_/24/ทต.สนามชัยเขต,TH/E_/24,4309,2287,2022,2900
865,ทต.สบบง,TH/N_/56/ทต.สบบง,TH/N_/56,7930,4112,3818,3376
866,ทต.สบปราบ,TH/N_/52/ทต.สบปราบ,TH/N_/52,5516,2895,2621,2069
867,ทต.สมเด็จ,TH/NE/46/ทต.สมเด็จ,TH/NE/46,6862,3523,3339,3306
868,ทต.สรรพยา,TH/CT/18/ทต.สรรพยา,TH/CT/18,3117,1619,1498,1355
869,ทต.สระกระโจม,TH/CT/72/ทต.สระกระโจม,TH/CT/72,2405,1203,1202,970
870,ทต.สระบัว,TH/E_/25/ทต.สระบัว,TH/E_/25,1839,938,901,631
871,ทต.สระพังทอง,TH/NE/46/ทต.สระพังทอง,TH/NE/46,2798,1388,1410,995
872,ทต.สระยายโสม,TH/CT/72/ทต.สระยายโสม,TH/CT/72,2848,1499,1349,1043
873,ทต.สระโบสถ์,TH/CT/16/ทต.สระโบสถ์,TH/CT/16,7274,3795,3479,3251
874,ทต.สร้างก่อ,TH/NE/41/ทต.สร้างก่อ,TH/NE/41,3952,1960,1992,1074
875,ทต.สร้างคอม,TH/NE/41/ทต.สร้างคอม,TH/NE/41,7389,3756,3633,2597
876,ทต.สลกบาตร,TH/CT/62/ทต.สลกบาตร,TH/CT/62,8196,4291,3905,4406
877,ทต.สวนดอกไม้,TH/CT/19/ทต.สวนดอกไม้,TH/CT/19,7639,4023,3616,3979
878,ทต.สวนผึ้ง,TH/W_/70/ทต.สวนผึ้ง,TH/W_/70,3439,1716,1723,1846
879,ทต.สวนหลวง,TH/CT/74/ทต.สวนหลวง,TH/CT/74,35271,17598,17673,21467
880,ทต.สวนแตง,TH/CT/72/ทต.สวนแตง,TH/CT/72,6612,3417,3195,2285
881,ทต.สว่างวัฒนา,TH/CT/67/ทต.สว่างวัฒนา,TH/CT/67,6585,3412,3173,2893
882,ทต.สว่างอารมณ์,TH/CT/61/ทต.สว่างอารมณ์,TH/CT/61,1640,841,799,966
883,ทต.สว่างแดนดิน,TH/NE/47/ทต.สว่างแดนดิน,TH/NE/47,8291,4325,3966,4561
884,ทต.สอง,TH/N_/54/ทต.สอง,TH/N_/54,6721,3648,3073,3101
885,ทต.สะบ้าย้อย,TH/S_/90/ทต.สะบ้าย้อย,TH/S_/90,1306,681,625,786
886,ทต.สะพลี,TH/S_/86/ทต.สะพลี,TH/S_/86,2214,1161,1053,1131
887,ทต.สะอาด,TH/NE/ขอนแก่น/ทต.สะอาด,TH/NE/ขอนแก่น,9997,5014,4983,2670
888,ทต.สะเมิงใต้,TH/N_/เชียงใหม่/ทต.สะเมิงใต้,TH/N_/เชียงใหม่,5372,2683,2689,2531
889,ทต.สังขะ,TH/S_/32/ทต.สังขะ,TH/S_/32,3850,2065,1785,2274
890,ทต.สังคม,TH/NE/43/ทต.สังคม,TH/NE/43,3312,1690,1622,1421
891,ทต.สันกำแพง,TH/N_/เชียงใหม่/ทต.สันกำแพง,TH/N_/เชียงใหม่,17650,9463,8187,8989
892,ทต.สันทราย,TH/N_/57/ทต.สันทราย,TH/N_/57,2607,1367,1240,1234
893,ทต.สันทรายหลวง,TH/N_/เชียงใหม่/ทต.สันทรายหลวง,TH/N_/เชียงใหม่,28337,15455,12882,15144
894,ทต.สันนาเม็ง,TH/N_/เชียงใหม่/ทต.สันนาเม็ง,TH/N_/เชียงใหม่,12774,6921,5853,8138
895,ทต.สันปูเลย,TH/N_/เชียงใหม่/ทต.สันปูเลย,TH/N_/เชียงใหม่,16593,8904,7689,9034
896,ทต.สันป่าตอง,TH/N_/เชียงใหม่/ทต.สันป่าตอง,TH/N_/เชียงใหม่,4461,2412,2049,2745
897,ทต.สันพระเนตร,TH/N_/เชียงใหม่/ทต.สันพระเนตร,TH/N_/เชียงใหม่,6139,3323,2816,3322
898,ทต.สันมหาพน,TH/N_/เชียงใหม่/ทต.สันมหาพน,TH/N_/เชียงใหม่,8383,4421,3962,4984
899,ทต.สากเหล็ก,TH/CT/66/ทต.สากเหล็ก,TH/CT/66,5252,2760,2492,2364
900,ทต.สามกอ,TH/CT/14/ทต.สามกอ,TH/CT/14,7024,3683,3341,2904
901,ทต.สามง่าม,TH/CT/66/ทต.สามง่าม,TH/CT/66,4793,2551,2242,2257
902,ทต.สามง่าม,TH/CT/73/ทต.สามง่าม,TH/CT/73,13913,7239,6674,4830
903,ทต.สามง่ามท่าโบสถ์,TH/CT/18/ทต.สามง่ามท่าโบสถ์,TH/CT/18,1348,699,649,471
904,ทต.สามชุก,TH/CT/72/ทต.สามชุก,TH/CT/72,12888,6809,6079,6747
905,ทต.สามัคคีพัฒนา,TH/NE/47/ทต.สามัคคีพัฒนา,TH/NE/47,9010,4542,4468,2369
906,ทต.สามเงา,TH/W_/63/ทต.สามเงา,TH/W_/63,4601,2419,2182,2085
907,ทต.สามเมือง,TH/CT/14/ทต.สามเมือง,TH/CT/14,7382,3742,3640,2819
908,ทต.สามแยก,TH/NE/35/ทต.สามแยก,TH/NE/35,3890,1987,1903,2204
909,ทต.สามโก้,TH/CT/15/ทต.สามโก้,TH/CT/15,10686,5606,5080,3504
910,ทต.สารภี,TH/N_/เชียงใหม่/ทต.สารภี,TH/N_/เชียงใหม่,7142,3775,3367,2667
911,ทต.สาวะถี,TH/NE/ขอนแก่น/ทต.สาวะถี,TH/NE/ขอนแก่น,18167,9217,8950,5624
912,ทต.สำนักขาม,TH/S_/90/ทต.สำนักขาม,TH/S_/90,13746,7415,6331,9249
913,ทต.สำนักขุนเณร,TH/CT/66/ทต.สำนักขุนเณร,TH/CT/66,2215,1116,1099,886
914,ทต.สำนักท้อน,TH/E_/21/ทต.สำนักท้อน,TH/E_/21,11251,5711,5540,5898
915,ทต.สำรอง,TH/W_/71/ทต.สำรอง,TH/W_/71,1843,942,901,629
916,ทต.สำโรงทาบ,TH/S_/32/ทต.สำโรงทาบ,TH/S_/32,2356,1197,1159,1248
917,ทต.สำโรงเหนือ,TH/CT/11/ทต.สำโรงเหนือ,TH/CT/11,30633,16611,14022,29943
918,ทต.สำโรงใหม่,TH/NE/31/ทต.สำโรงใหม่,TH/NE/31,12676,6333,6343,3711
919,ทต.สิชล,TH/S_/นครศรีธรรมราช/ทต.สิชล,TH/S_/นครศรีธรรมราช,6958,3590,3368,3978
920,ทต.สิริราช,TH/N_/52/ทต.สิริราช,TH/N_/52,4587,2236,2351,1580
921,ทต.สิเกา,TH/S_/92/ทต.สิเกา,TH/S_/92,1427,740,687,661
922,ทต.สีชมพู,TH/NE/ขอนแก่น/ทต.สีชมพู,TH/NE/ขอนแก่น,3393,1725,1668,1539
923,ทต.สีดา,TH/NE/30/ทต.สีดา,TH/NE/30,3629,1838,1791,1425
924,ทต.สีมามงคล,TH/NE/30/ทต.สีมามงคล,TH/NE/30,8965,4494,4471,4221
925,ทต.สุคิริน,TH/S_/96/ทต.สุคิริน,TH/S_/96,3471,1688,1783,1569
926,ทต.สุนทรภู่,TH/E_/21/ทต.สุนทรภู่,TH/E_/21,14986,7838,7148,9995
927,ทต.สุวรรณคูหา,TH/NE/39/ทต.สุวรรณคูหา,TH/NE/39,7789,3976,3813,2825
928,ทต.สุวรรณภูมิ,TH/NE/45/ทต.สุวรรณภูมิ,TH/NE/45,9071,4782,4289,4199
929,ทต.สุเทพ,TH/N_/เชียงใหม่/ทต.สุเทพ,TH/N_/เชียงใหม่,17108,8631,8477,11293
930,ทต.สูงเนิน,TH/NE/30/ทต.สูงเนิน,TH/NE/30,9861,5234,4627,6217
931,ทต.สูงเม่น,TH/N_/54/ทต.สูงเม่น,TH/N_/54,3790,2039,1751,1896
932,ทต.ส่องดาว,TH/NE/47/ทต.ส่องดาว,TH/NE/47,4935,2467,2468,1551
933,ทต.หงส์หิน,TH/N_/56/ทต.หงส์หิน,TH/N_/56,6748,3461,3287,2730
934,ทต.หงาว,TH/S_/85/ทต.หงาว,TH/S_/85,2489,1284,1205,1093
935,ทต.หนองกราด,TH/NE/30/ทต.หนองกราด,TH/NE/30,4074,2117,1957,1336
936,ทต.หนองกี่,TH/NE/31/ทต.หนองกี่,TH/NE/31,9834,5081,4753,4111
937,ทต.หนองกุงศรี,TH/NE/46/ทต.หนองกุงศรี,TH/NE/46,8918,4512,4406,3380
938,ทต.หนองขาว,TH/W_/71/ทต.หนองขาว,TH/W_/71,5089,2673,2416,1608
939,ทต.หนองขาหย่าง,TH/CT/61/ทต.หนองขาหย่าง,TH/CT/61,592,311,281,326
940,ทต.หนองคล้า,TH/E_/22/ทต.หนองคล้า,TH/E_/22,3777,1994,1783,2141
941,ทต.หนองจอก,TH/W_/76/ทต.หนองจอก,TH/W_/76,2736,1452,1284,1001
942,ทต.หนองจิก,TH/S_/94/ทต.หนองจิก,TH/S_/94,6292,3149,3143,1982
943,ทต.หนองจ๊อม,TH/N_/เชียงใหม่/ทต.หนองจ๊อม,TH/N_/เชียงใหม่,17111,9319,7792,9153
944,ทต.หนองฉาง,TH/CT/61/ทต.หนองฉาง,TH/CT/61,2775,1472,1303,1888
945,ทต.หนองตองพัฒนา,TH/N_/เชียงใหม่/ทต.หนองตองพัฒนา,TH/N_/เชียงใหม่,8433,4501,3932,3521
946,ทต.หนองตากยา,TH/W_/71/ทต.หนองตากยา,TH/W_/71,3012,1541,1471,949
947,ทต.หนองตาคง,TH/E_/22/ทต.หนองตาคง,TH/E_/22,9966,4852,5114,3981
948,ทต.หนองตำลึง,TH/E_/ชลบุรี/ทต.หนองตำลึง,TH/E_/ชลบุรี,21094,10661,10433,16219
949,ทต.หนองตูม,TH/NE/ขอนแก่น/ทต.หนองตูม,TH/NE/ขอนแก่น,7720,3984,3736,2191
950,ทต.หนองน้ำใส,TH/NE/30/ทต.หนองน้ำใส,TH/NE/30,13267,6629,6638,4973
951,ทต.หนองบอน,TH/E_/23/ทต.หนองบอน,TH/E_/23,7501,3700,3801,3911
952,ทต.หนองบัว,TH/E_/22/ทต.หนองบัว,TH/E_/22,2275,1211,1064,971
953,ทต.หนองบัว,TH/NE/41/ทต.หนองบัว,TH/NE/41,33143,17220,15923,15723
954,ทต.หนองบัว,TH/CT/60/ทต.หนองบัว,TH/CT/60,11637,6082,5555,4981
955,ทต.หนองบัว,TH/W_/71/ทต.หนองบัว,TH/W_/71,6469,3407,3062,2908
956,ทต.หนองบัวตะเกียด,TH/NE/30/ทต.หนองบัวตะเกียด,TH/NE/30,8781,4512,4269,2640
957,ทต.หนองบัวระเหว,TH/NE/36/ทต.หนองบัวระเหว,TH/NE/36,5911,2980,2931,2599
958,ทต.หนองบัวลาย,TH/NE/30/ทต.หนองบัวลาย,TH/NE/30,2470,1241,1229,855
959,ทต.หนองบัววง,TH/NE/30/ทต.หนองบัววง,TH/NE/30,4623,2335,2288,1814
960,ทต.หนองบัวแดง,TH/NE/36/ทต.หนองบัวแดง,TH/NE/36,8872,4514,4358,4207
961,ทต.หนองบัวโคก,TH/NE/36/ทต.หนองบัวโคก,TH/NE/36,1999,1013,986,782
962,ทต.หนองปรือ,TH/W_/71/ทต.หนองปรือ,TH/W_/71,4437,2276,2161,1743
963,ทต.หนองปล้อง,TH/CT/66/ทต.หนองปล้อง,TH/CT/66,3410,1734,1676,1142
964,ทต.หนองป่าครั่ง,TH/N_/เชียงใหม่/ทต.หนองป่าครั่ง,TH/N_/เชียงใหม่,7323,3948,3375,6035
965,ทต.หนองผึ้ง,TH/N_/เชียงใหม่/ทต.หนองผึ้ง,TH/N_/เชียงใหม่,15580,8380,7200,8718
966,ทต.หนองผือ,TH/NE/34/ทต.หนองผือ,TH/NE/34,9936,5070,4866,3348
967,ทต.หนองฝ้าย,TH/W_/71/ทต.หนองฝ้าย,TH/W_/71,2212,1142,1070,957
968,ทต.หนองพยอม,TH/CT/66/ทต.หนองพยอม,TH/CT/66,6795,3466,3329,2290
969,ทต.หนองพลับ,TH/W_/ประจวบคีรีขันธ์/ทต.หนองพลับ,TH/W_/ประจวบคีรีขันธ์,4714,2450,2264,2828
970,ทต.หนองพอก,TH/NE/45/ทต.หนองพอก,TH/NE/45,6504,3335,3169,2623
971,ทต.หนองม่วง,TH/CT/16/ทต.หนองม่วง,TH/CT/16,5042,2600,2442,2134
972,ทต.หนองม่วงไข่,TH/N_/54/ทต.หนองม่วงไข่,TH/N_/54,4473,2402,2071,1880
973,ทต.หนองยวง,TH/N_/51/ทต.หนองยวง,TH/N_/51,3690,1924,1766,1793
974,ทต.หนองรี,TH/W_/71/ทต.หนองรี,TH/W_/71,2131,1100,1031,789
975,ทต.หนองล่อง,TH/N_/51/ทต.หนองล่อง,TH/N_/51,5616,2902,2714,2513
976,ทต.หนองวัวซอ,TH/NE/41/ทต.หนองวัวซอ,TH/NE/41,9648,4943,4705,2845
977,ทต.หนองสระ,TH/CT/61/ทต.หนองสระ,TH/CT/61,2146,1138,1008,668
978,ทต.หนองสอ,TH/NE/46/ทต.หนองสอ,TH/NE/46,7280,3770,3510,2240
979,ทต.หนองสองห้อง,TH/NE/43/ทต.หนองสองห้อง,TH/NE/43,5319,2671,2648,2051
980,ทต.หนองสองห้อง,TH/NE/ขอนแก่น/ทต.หนองสองห้อง,TH/NE/ขอนแก่น,5890,2978,2912,2737
981,ทต.หนองสาหร่าย,TH/W_/71/ทต.หนองสาหร่าย,TH/W_/71,3652,1924,1728,1197
982,ทต.หนองหงส์,TH/NE/31/ทต.หนองหงส์,TH/NE/31,4748,2376,2372,1715
983,ทต.หนองหญ้าไซ,TH/CT/72/ทต.หนองหญ้าไซ,TH/CT/72,2539,1320,1219,1085
984,ทต.หนองหมู,TH/CT/19/ทต.หนองหมู,TH/CT/19,1674,856,818,494
985,ทต.หนองหว้า,TH/NE/41/ทต.หนองหว้า,TH/NE/41,8174,4102,4072,2014
986,ทต.หนองหอย,TH/N_/เชียงใหม่/ทต.หนองหอย,TH/N_/เชียงใหม่,7811,4267,3544,5443
987,ทต.หนองหัวฟาน,TH/NE/30/ทต.หนองหัวฟาน,TH/NE/30,4550,2287,2263,1405
988,ทต.หนองหาน,TH/NE/41/ทต.หนองหาน,TH/NE/41,4248,2228,2020,1868
989,ทต.หนองหิน,TH/NE/42/ทต.หนองหิน,TH/NE/42,4449,2259,2190,2006
990,ทต.หนองหิน,TH/NE/46/ทต.หนองหิน,TH/NE/46,5359,2714,2645,1596
991,ทต.หนองเบน,TH/CT/60/ทต.หนองเบน,TH/CT/60,2960,1615,1345,1495
992,ทต.หนองเม็ก,TH/NE/41/ทต.หนองเม็ก,TH/NE/41,8247,4139,4108,2230
993,ทต.หนองเรือ,TH/NE/ขอนแก่น/ทต.หนองเรือ,TH/NE/ขอนแก่น,4293,2136,2157,2133
994,ทต.หนองเสือ,TH/CT/ปทุมธานี/ทต.หนองเสือ,TH/CT/ปทุมธานี,3036,1571,1465,1870
995,ทต.หนองแก,TH/NE/ขอนแก่น/ทต.หนองแก,TH/NE/ขอนแก่น,1435,718,717,690
996,ทต.หนองแค,TH/CT/19/ทต.หนองแค,TH/CT/19,12401,6413,5988,6325
997,ทต.หนองแซง,TH/CT/18/ทต.หนองแซง,TH/CT/18,7764,3963,3801,2733
998,ทต.หนองแซง,TH/CT/19/ทต.หนองแซง,TH/CT/19,2850,1484,1366,1014
999,ทต.หนองแปน,TH/NE/46/ทต.หนองแปน,TH/NE/46,6771,3521,3250,2146
1000,ทต.หนองแวง,TH/NE/31/ทต.หนองแวง,TH/NE/31,16807,8322,8485,4175
1001,ทต.หนองโดน,TH/CT/19/ทต.หนองโดน,TH/CT/19,2414,1274,1140,1033
1002,ทต.หนองโพ,TH/W_/70/ทต.หนองโพ,TH/W_/70,3904,2067,1837,2156
1003,ทต.หนองใหญ่,TH/E_/ชลบุรี/ทต.หนองใหญ่,TH/E_/ชลบุรี,8509,4167,4342,3367
1004,ทต.หนองไข่น้ำ,TH/NE/30/ทต.หนองไข่น้ำ,TH/NE/30,6164,3070,3094,1802
1005,ทต.หนองไผ่,TH/NE/41/ทต.หนองไผ่,TH/NE/41,18274,9528,8746,5400
1006,ทต.หนองไผ่,TH/CT/67/ทต.หนองไผ่,TH/CT/67,7369,3849,3520,3836
1007,ทต.หนองไผ่ล้อม,TH/NE/30/ทต.หนองไผ่ล้อม,TH/NE/30,15913,4668,11245,11289
1008,ทต.หนองไผ่แก้ว,TH/E_/ชลบุรี/ทต.หนองไผ่แก้ว,TH/E_/ชลบุรี,2322,1207,1115,1571
1009,ทต.หนองไม้งาม,TH/NE/31/ทต.หนองไม้งาม,TH/NE/31,10099,5035,5064,2880
1010,ทต.หนองไม้แดง,TH/E_/ชลบุรี/ทต.หนองไม้แดง,TH/E_/ชลบุรี,13127,6351,6776,11074
1011,ทต.หน้าพระลาน,TH/CT/19/ทต.หน้าพระลาน,TH/CT/19,7921,3944,3977,3292
1012,ทต.หน้าสตน,TH/S_/นครศรีธรรมราช/ทต.หน้าสตน,TH/S_/นครศรีธรรมราช,8306,4164,4142,2902
1013,ทต.หมอนนาง,TH/E_/ชลบุรี/ทต.หมอนนาง,TH/E_/ชลบุรี,13643,7049,6594,4432
1014,ทต.หมูสี,TH/NE/30/ทต.หมูสี,TH/NE/30,13275,6676,6599,11414
1015,ทต.หลวงเหนือ,TH/N_/52/ทต.หลวงเหนือ,TH/N_/52,4165,2193,1972,2320
1016,ทต.หลักห้า,TH/CT/74/ทต.หลักห้า,TH/CT/74,41884,21555,20329,10326
1017,ทต.หลักเมือง,TH/W_/70/ทต.หลักเมือง,TH/W_/70,17534,8047,9487,6990
1018,ทต.หลุมดิน,TH/W_/70/ทต.หลุมดิน,TH/W_/70,5124,2607,2517,1742
1019,ทต.หล่มเก่า,TH/CT/67/ทต.หล่มเก่า,TH/CT/67,5928,3129,2799,2624
1020,ทต.หวายเหนียว,TH/W_/71/ทต.หวายเหนียว,TH/W_/71,4294,2224,2070,1836
1021,ทต.หอคำ,TH/NE/38/ทต.หอคำ,TH/NE/38,7246,3606,3640,2304
1022,ทต.หอมศีล,TH/E_/24/ทต.หอมศีล,TH/E_/24,1282,632,650,327
1023,ทต.หอไกร,TH/CT/66/ทต.หอไกร,TH/CT/66,5903,3019,2884,2671
1024,ทต.หันคา,TH/CT/18/ทต.หันคา,TH/CT/18,4119,2185,1934,2413
1025,ทต.หัวกุญแจ,TH/E_/ชลบุรี/ทต.หัวกุญแจ,TH/E_/ชลบุรี,3826,2009,1817,2080
1026,ทต.หัวช้าง,TH/NE/45/ทต.หัวช้าง,TH/NE/45,8230,4221,4009,2604
1027,ทต.หัวดง,TH/N_/53/ทต.หัวดง,TH/N_/53,5529,2840,2689,2133
1028,ทต.หัวดง,TH/CT/66/ทต.หัวดง,TH/CT/66,3170,1626,1544,1174
1029,ทต.หัวตะพาน,TH/NE/37/ทต.หัวตะพาน,TH/NE/37,6783,3465,3318,2166
1030,ทต.หัวทะเล,TH/NE/30/ทต.หัวทะเล,TH/NE/30,27740,14508,13232,13551
1031,ทต.หัวนา,TH/NE/34/ทต.หัวนา,TH/NE/34,13284,6698,6586,3512
1032,ทต.หัวนา,TH/NE/39/ทต.หัวนา,TH/NE/39,3630,1795,1835,1031
1033,ทต.หัวนาคำ,TH/NE/41/ทต.หัวนาคำ,TH/NE/41,11359,5585,5774,3153
1034,ทต.หัวนาคำ,TH/NE/46/ทต.หัวนาคำ,TH/NE/46,12788,6536,6252,3710
1035,ทต.หัวสะพาน,TH/W_/76/ทต.หัวสะพาน,TH/W_/76,5958,3120,2838,1993
1036,ทต.หัวสำโรง,TH/E_/24/ทต.หัวสำโรง,TH/E_/24,6701,3426,3275,3884
1037,ทต.หัวเวียง,TH/CT/14/ทต.หัวเวียง,TH/CT/14,5949,3078,2871,1800
1038,ทต.หัวไทร,TH/S_/นครศรีธรรมราช/ทต.หัวไทร,TH/S_/นครศรีธรรมราช,4215,2188,2027,1832
1039,ทต.หางดง,TH/N_/เชียงใหม่/ทต.หางดง,TH/N_/เชียงใหม่,7269,3925,3344,3813
1040,ทต.หางน้ำสาคร,TH/CT/18/ทต.หางน้ำสาคร,TH/CT/18,6122,3170,2952,3069
1041,ทต.หาดกรวด,TH/N_/53/ทต.หาดกรวด,TH/N_/53,7529,3868,3661,2626
1042,ทต.หาดคำ,TH/NE/43/ทต.หาดคำ,TH/NE/43,9355,4754,4601,2931
1043,ทต.หาดท่าเสา,TH/CT/18/ทต.หาดท่าเสา,TH/CT/18,5052,2591,2461,1782
1044,ทต.หาดเจ้าสำราญ,TH/W_/76/ทต.หาดเจ้าสำราญ,TH/W_/76,4933,2567,2366,2513
1045,ทต.หาดเล็ก,TH/E_/23/ทต.หาดเล็ก,TH/E_/23,5351,2605,2746,1967
1046,ทต.หาดเสี้ยว,TH/CT/64/ทต.หาดเสี้ยว,TH/CT/64,6589,3499,3090,3584
1047,ทต.หารเทา,TH/S_/93/ทต.หารเทา,TH/S_/93,10041,5092,4949,3472
1048,ทต.หินกอง,TH/CT/19/ทต.หินกอง,TH/CT/19,9407,4981,4426,5566
1049,ทต.หินดาด,TH/NE/30/ทต.หินดาด,TH/NE/30,2799,1389,1410,765
1050,ทต.หินตก,TH/S_/นครศรีธรรมราช/ทต.หินตก,TH/S_/นครศรีธรรมราช,8343,4172,4171,2724
1051,ทต.หินเหล็กไฟ,TH/NE/31/ทต.หินเหล็กไฟ,TH/NE/31,5056,2550,2506,1803
1052,ทต.ห้วยกระบอก,TH/W_/70/ทต.ห้วยกระบอก,TH/W_/70,1696,874,822,729
1053,ทต.ห้วยกะปิ,TH/E_/ชลบุรี/ทต.ห้วยกะปิ,TH/E_/ชลบุรี,16395,8699,7696,10120
1054,ทต.ห้วยขะยุง,TH/NE/34/ทต.ห้วยขะยุง,TH/NE/34,3185,1634,1551,973
1055,ทต.ห้วยข้าวก่ำ,TH/N_/56/ทต.ห้วยข้าวก่ำ,TH/N_/56,8241,4281,3960,4133
1056,ทต.ห้วยชินสีห์,TH/W_/70/ทต.ห้วยชินสีห์,TH/W_/70,11344,5890,5454,4284
1057,ทต.ห้วยซ้อ,TH/N_/57/ทต.ห้วยซ้อ,TH/N_/57,12416,6204,6212,5237
1058,ทต.ห้วยทับทัน,TH/NE/33/ทต.ห้วยทับทัน,TH/NE/33,3328,1630,1698,1053
1059,ทต.ห้วยผึ้ง,TH/NE/46/ทต.ห้วยผึ้ง,TH/NE/46,5769,2942,2827,2243
1060,ทต.ห้วยพลู,TH/CT/73/ทต.ห้วยพลู,TH/CT/73,2185,1155,1030,890
1061,ทต.ห้วยยอด,TH/S_/92/ทต.ห้วยยอด,TH/S_/92,8252,4320,3932,4110
1062,ทต.ห้วยยาง,TH/NE/36/ทต.ห้วยยาง,TH/NE/36,15462,7702,7760,4582
1063,ทต.ห้วยราช,TH/NE/31/ทต.ห้วยราช,TH/NE/31,5094,2579,2515,1382
1064,ทต.ห้วยลาน,TH/N_/56/ทต.ห้วยลาน,TH/N_/56,8915,4645,4270,3275
1065,ทต.ห้วยหิน,TH/NE/31/ทต.ห้วยหิน,TH/NE/31,9742,4890,4852,2569
1066,ทต.ห้วยอ้อ,TH/N_/54/ทต.ห้วยอ้อ,TH/N_/54,4860,2586,2274,2218
1067,ทต.ห้วยเกิ้ง,TH/NE/41/ทต.ห้วยเกิ้ง,TH/NE/41,5308,2700,2608,1684
1068,ทต.ห้วยเม็ก,TH/NE/46/ทต.ห้วยเม็ก,TH/NE/46,5701,2912,2789,2171
1069,ทต.ห้วยแถลง,TH/NE/30/ทต.ห้วยแถลง,TH/NE/30,3177,1664,1513,1605
1070,ทต.ห้วยโพธิ์,TH/NE/46/ทต.ห้วยโพธิ์,TH/NE/46,11803,5946,5857,3378
1071,ทต.ห้วยใหญ่,TH/E_/ชลบุรี/ทต.ห้วยใหญ่,TH/E_/ชลบุรี,30653,16181,14472,17569
1072,ทต.ห้วยไคร้,TH/N_/57/ทต.ห้วยไคร้,TH/N_/57,5036,2705,2331,2501
1073,ทต.ห้างฉัตร,TH/N_/52/ทต.ห้างฉัตร,TH/N_/52,2783,1532,1251,1288
1074,ทต.องครักษ์,TH/CT/26/ทต.องครักษ์,TH/CT/26,2638,1366,1272,1296
1075,ทต.อมก๋อย,TH/N_/เชียงใหม่/ทต.อมก๋อย,TH/N_/เชียงใหม่,1078,526,552,825
1076,ทต.อรัญญิก,TH/CT/14/ทต.อรัญญิก,TH/CT/14,7785,4040,3745,2810
1077,ทต.อัคคะคำ,TH/NE/45/ทต.อัคคะคำ,TH/NE/45,8175,4075,4100,2105
1078,ทต.อัมพวา,TH/CT/75/ทต.อัมพวา,TH/CT/75,4731,2471,2260,1961
1079,ทต.อากาศอำนวย,TH/NE/47/ทต.อากาศอำนวย,TH/NE/47,8984,4605,4379,3026
1080,ทต.อาจสามารถ,TH/NE/45/ทต.อาจสามารถ,TH/NE/45,4019,2059,1960,1769
1081,ทต.อำนาจ,TH/NE/37/ทต.อำนาจ,TH/NE/37,2127,1138,989,959
1082,ทต.อิตื้อ,TH/NE/46/ทต.อิตื้อ,TH/NE/46,8761,4430,4331,2495
1083,ทต.อินทร์บุรี,TH/CT/17/ทต.อินทร์บุรี,TH/CT/17,4557,2388,2169,2278
1084,ทต.อิสาณ,TH/NE/31/ทต.อิสาณ,TH/NE/31,21116,11070,10046,12564
1085,ทต.อุทัย,TH/CT/14/ทต.อุทัย,TH/CT/14,6620,3523,3097,4077
1086,ทต.อุบล,TH/NE/34/ทต.อุบล,TH/NE/34,5780,3123,2657,3098
1087,ทต.อุโมงค์,TH/N_/51/ทต.อุโมงค์,TH/N_/51,12882,6855,6027,5915
1088,ทต.อุ่มเม้า,TH/NE/45/ทต.อุ่มเม้า,TH/NE/45,7316,3720,3596,2013
1089,ทต.อุ้มผาง,TH/W_/63/ทต.อุ้มผาง,TH/W_/63,3706,1794,1912,898
1090,ทต.อู่ทอง,TH/CT/72/ทต.อู่ทอง,TH/CT/72,7571,3996,3575,3662
1091,ทต.อ่างศิลา,TH/NE/34/ทต.อ่างศิลา,TH/NE/34,3109,1618,1491,1006
1092,ทต.อ่าวพะยูน,TH/S_/93/ทต.อ่าวพะยูน,TH/S_/93,4650,2372,2278,1634
1093,ทต.อ่าวลึกใต้,TH/S_/81/ทต.อ่าวลึกใต้,TH/S_/81,5665,2954,2711,2915
1094,ทต.อ้อมใหญ่,TH/CT/73/ทต.อ้อมใหญ่,TH/CT/73,24273,12673,11600,21722
1095,ทต.เกล็ดแก้ว,TH/E_/ชลบุรี/ทต.เกล็ดแก้ว,TH/E_/ชลบุรี,12802,5316,7486,6346
1096,ทต.เกวียนหัก,TH/E_/22/ทต.เกวียนหัก,TH/E_/22,4530,2437,2093,2149
1097,ทต.เกษตรพัฒนา,TH/CT/74/ทต.เกษตรพัฒนา,TH/CT/74,5092,2641,2451,1564
1098,ทต.เกษตรวิสัย,TH/NE/45/ทต.เกษตรวิสัย,TH/NE/45,10978,5658,5320,4820
1099,ทต.เกษตรสมบูรณ์,TH/NE/36/ทต.เกษตรสมบูรณ์,TH/NE/36,2956,1552,1404,1313
1100,ทต.เกษไชโย,TH/CT/15/ทต.เกษไชโย,TH/CT/15,2793,1413,1380,949
1101,ทต.เกาะขนุน,TH/E_/24/ทต.เกาะขนุน,TH/E_/24,2163,1123,1040,1090
1102,ทต.เกาะขวาง,TH/E_/22/ทต.เกาะขวาง,TH/E_/22,16642,8712,7930,7979
1103,ทต.เกาะคา,TH/N_/52/ทต.เกาะคา,TH/N_/52,4546,2432,2114,2337
1104,ทต.เกาะจันทร์,TH/E_/ชลบุรี/ทต.เกาะจันทร์,TH/E_/ชลบุรี,5227,1840,3387,1798
1105,ทต.เกาะพะงัน,TH/S_/84/ทต.เกาะพะงัน,TH/S_/84,7465,3759,3706,5471
1106,ทต.เกาะยาว,TH/S_/82/ทต.เกาะยาว,TH/S_/82,833,424,409,495
1107,ทต.เกาะลันตาใหญ่,TH/S_/81/ทต.เกาะลันตาใหญ่,TH/S_/81,1172,602,570,497
1108,ทต.เกาะสีชัง,TH/E_/ชลบุรี/ทต.เกาะสีชัง,TH/E_/ชลบุรี,4494,2268,2226,2187
1109,ทต.เกาะหวาย,TH/CT/26/ทต.เกาะหวาย,TH/CT/26,1806,956,850,748
1110,ทต.เกาะเพชร,TH/S_/นครศรีธรรมราช/ทต.เกาะเพชร,TH/S_/นครศรีธรรมราช,6872,3385,3487,2121
1111,ทต.เกาะแต้ว,TH/S_/90/ทต.เกาะแต้ว,TH/S_/90,11482,5924,5558,3773
1112,ทต.เก้าเลี้ยว,TH/CT/60/ทต.เก้าเลี้ยว,TH/CT/60,5766,3000,2766,2293
1113,ทต.เขตรอุดมศักดิ์,TH/E_/ชลบุรี/ทต.เขตรอุดมศักดิ์,TH/E_/ชลบุรี,54984,21854,33130,26594
1114,ทต.เขมราฐ,TH/NE/34/ทต.เขมราฐ,TH/NE/34,5985,3103,2882,2486
1115,ทต.เขาขวาง,TH/W_/70/ทต.เขาขวาง,TH/W_/70,7274,3771,3503,2604
1116,ทต.เขางู,TH/W_/70/ทต.เขางู,TH/W_/70,9182,4777,4405,2844
1117,ทต.เขาฉกรรจ์,TH/E_/27/ทต.เขาฉกรรจ์,TH/E_/27,4842,2446,2396,2309
1118,ทต.เขาชัยสน,TH/S_/93/ทต.เขาชัยสน,TH/S_/93,3530,1861,1669,1597
1119,ทต.เขาชุมทอง,TH/S_/นครศรีธรรมราช/ทต.เขาชุมทอง,TH/S_/นครศรีธรรมราช,4341,2237,2104,1355
1120,ทต.เขาดิน,TH/CT/72/ทต.เขาดิน,TH/CT/72,6060,3105,2955,2079
1121,ทต.เขาทราย,TH/CT/66/ทต.เขาทราย,TH/CT/66,4356,2201,2155,1890
1122,ทต.เขานิพันธ์,TH/S_/84/ทต.เขานิพันธ์,TH/S_/84,6566,3312,3254,2759
1123,ทต.เขาบางแกรก,TH/CT/61/ทต.เขาบางแกรก,TH/CT/61,6241,3253,2988,2369
1124,ทต.เขาบายศรี,TH/E_/22/ทต.เขาบายศรี,TH/E_/22,6309,3209,3100,2504
1125,ทต.เขาพนม,TH/S_/81/ทต.เขาพนม,TH/S_/81,5752,2988,2764,2468
1126,ทต.เขาพระ,TH/CT/72/ทต.เขาพระ,TH/CT/72,5636,3026,2610,3229
1127,ทต.เขาพระ,TH/S_/นครศรีธรรมราช/ทต.เขาพระ,TH/S_/นครศรีธรรมราช,8188,4091,4097,3337
1128,ทต.เขาพระงาม,TH/CT/16/ทต.เขาพระงาม,TH/CT/16,25296,9267,16029,11806
1129,ทต.เขาย้อย,TH/W_/76/ทต.เขาย้อย,TH/W_/76,15339,8049,7290,8081
1130,ทต.เขาสมิง,TH/E_/23/ทต.เขาสมิง,TH/E_/23,1424,705,719,614
1131,ทต.เขาสวนกวาง,TH/NE/ขอนแก่น/ทต.เขาสวนกวาง,TH/NE/ขอนแก่น,10825,5441,5384,3633
1132,ทต.เขาหัวช้าง,TH/S_/93/ทต.เขาหัวช้าง,TH/S_/93,7146,3585,3561,2142
1133,ทต.เขาหินซ้อน,TH/E_/24/ทต.เขาหินซ้อน,TH/E_/24,3522,1793,1729,2587
1134,ทต.เขาแก้ว,TH/NE/42/ทต.เขาแก้ว,TH/NE/42,7789,3862,3927,2148
1135,ทต.เขื่องใน,TH/NE/34/ทต.เขื่องใน,TH/NE/34,4547,2332,2215,2053
1136,ทต.เขื่อนบางลาง,TH/S_/95/ทต.เขื่อนบางลาง,TH/S_/95,4485,2136,2349,2000
1137,ทต.เขื่อนอุบลรัตน์,TH/NE/ขอนแก่น/ทต.เขื่อนอุบลรัตน์,TH/NE/ขอนแก่น,4089,2079,2010,2075
1138,ทต.เคียนซา,TH/S_/84/ทต.เคียนซา,TH/S_/84,1706,838,868,741
1139,ทต.เจดีย์หลวง,TH/N_/57/ทต.เจดีย์หลวง,TH/N_/57,4820,2436,2384,2102
1140,ทต.เจดีย์แม่ครัว,TH/N_/เชียงใหม่/ทต.เจดีย์แม่ครัว,TH/N_/เชียงใหม่,8066,4227,3839,3862
1141,ทต.เจริญศิลป์,TH/NE/47/ทต.เจริญศิลป์,TH/NE/47,6859,3499,3360,2249
1142,ทต.เจ็ดเสมียน,TH/W_/70/ทต.เจ็ดเสมียน,TH/W_/70,5769,3021,2748,2219
1143,ทต.เจ้าเจ็ด,TH/CT/14/ทต.เจ้าเจ็ด,TH/CT/14,10748,5548,5200,3165
1144,ทต.เจ๊ะบิลัง,TH/S_/91/ทต.เจ๊ะบิลัง,TH/S_/91,4039,2023,2016,997
1145,ทต.เฉลียงทอง,TH/CT/67/ทต.เฉลียงทอง,TH/CT/67,7552,3779,3773,2556
1146,ทต.เชิงดอย,TH/N_/เชียงใหม่/ทต.เชิงดอย,TH/N_/เชียงใหม่,7720,4028,3692,3617
1147,ทต.เชิงทะเล,TH/S_/83/ทต.เชิงทะเล,TH/S_/83,6870,3806,3064,3661
1148,ทต.เชียงกลม,TH/NE/42/ทต.เชียงกลม,TH/NE/42,5172,2605,2567,1609
1149,ทต.เชียงกลาง,TH/N_/55/ทต.เชียงกลาง,TH/N_/55,9656,4926,4730,3909
1150,ทต.เชียงคาน,TH/NE/42/ทต.เชียงคาน,TH/NE/42,5167,2681,2486,2751
1151,ทต.เชียงคำ,TH/N_/56/ทต.เชียงคำ,TH/N_/56,6212,3389,2823,3667
1152,ทต.เชียงดาว,TH/N_/เชียงใหม่/ทต.เชียงดาว,TH/N_/เชียงใหม่,3974,2105,1869,2300
1153,ทต.เชียงม่วน,TH/N_/56/ทต.เชียงม่วน,TH/N_/56,8679,4355,4324,3845
1154,ทต.เชียงยืน,TH/NE/44/ทต.เชียงยืน,TH/NE/44,4687,2404,2283,2371
1155,ทต.เชียงรากน้อย,TH/CT/14/ทต.เชียงรากน้อย,TH/CT/14,10124,5229,4895,4340
1156,ทต.เชียงเครือ,TH/NE/47/ทต.เชียงเครือ,TH/NE/47,17243,8935,8308,5974
1157,ทต.เชียงเพ็ง,TH/NE/41/ทต.เชียงเพ็ง,TH/NE/41,3999,2007,1992,1162
1158,ทต.เชียงใหม่,TH/NE/45/ทต.เชียงใหม่,TH/NE/45,8223,4160,4063,2404
1159,ทต.เชียรใหญ่,TH/S_/นครศรีธรรมราช/ทต.เชียรใหญ่,TH/S_/นครศรีธรรมราช,1622,818,804,748
1160,ทต.เดิมบาง,TH/CT/72/ทต.เดิมบาง,TH/CT/72,6770,3615,3155,2798
1161,ทต.เด่นชัย,TH/N_/54/ทต.เด่นชัย,TH/N_/54,11069,5822,5247,5144
1162,ทต.เทพกระษัตรี,TH/S_/83/ทต.เทพกระษัตรี,TH/S_/83,9256,4760,4496,4982
1163,ทต.เทพนคร,TH/CT/62/ทต.เทพนคร,TH/CT/62,20042,10289,9753,8332
1164,ทต.เทพราช,TH/E_/24/ทต.เทพราช,TH/E_/24,4274,2179,2095,1259
1165,ทต.เทพวงศา,TH/NE/34/ทต.เทพวงศา,TH/NE/34,11933,5926,6007,4039
1166,ทต.เทพสถิต,TH/NE/36/ทต.เทพสถิต,TH/NE/36,3842,1926,1916,2261
1167,ทต.เทพา,TH/S_/90/ทต.เทพา,TH/S_/90,2350,1200,1150,1056
1168,ทต.เทพาลัย,TH/NE/30/ทต.เทพาลัย,TH/NE/30,2802,1453,1349,839
1169,ทต.เนินกุ่ม,TH/CT/65/ทต.เนินกุ่ม,TH/CT/65,12005,6161,5844,4505
1170,ทต.เนินขาม,TH/CT/18/ทต.เนินขาม,TH/CT/18,5984,3133,2851,2622
1171,ทต.เนินฆ้อ,TH/E_/21/ทต.เนินฆ้อ,TH/E_/21,4599,2362,2237,1925
1172,ทต.เนินปอ,TH/CT/66/ทต.เนินปอ,TH/CT/66,9069,4538,4531,3069
1173,ทต.เนินมะกอก,TH/CT/66/ทต.เนินมะกอก,TH/CT/66,6804,3531,3273,2981
1174,ทต.เนินมะปราง,TH/CT/65/ทต.เนินมะปราง,TH/CT/65,3450,1780,1670,1583
1175,ทต.เนินสันติ,TH/S_/86/ทต.เนินสันติ,TH/S_/86,1878,974,904,1248
1176,ทต.เนินสูง,TH/E_/22/ทต.เนินสูง,TH/E_/22,3029,1585,1444,1646
1177,ทต.เบิกไพร,TH/W_/70/ทต.เบิกไพร,TH/W_/70,16073,8514,7559,6524
1178,ทต.เปือยน้อย,TH/NE/ขอนแก่น/ทต.เปือยน้อย,TH/NE/ขอนแก่น,5902,3027,2875,1976
1179,ทต.เฝ้าไร่,TH/NE/43/ทต.เฝ้าไร่,TH/NE/43,10942,5478,5464,3989
1180,ทต.เพ็ญ,TH/NE/41/ทต.เพ็ญ,TH/NE/41,2785,1403,1382,1578
1181,ทต.เมืองการุ้ง,TH/CT/61/ทต.เมืองการุ้ง,TH/CT/61,2135,1130,1005,991
1182,ทต.เมืองขุขันธ์,TH/NE/33/ทต.เมืองขุขันธ์,TH/NE/33,4369,2247,2122,2167
1183,ทต.เมืองคง,TH/NE/30/ทต.เมืองคง,TH/NE/30,2228,1157,1071,995
1184,ทต.เมืองคง,TH/NE/33/ทต.เมืองคง,TH/NE/33,3984,2038,1946,2101
1185,ทต.เมืองงาย,TH/N_/เชียงใหม่/ทต.เมืองงาย,TH/N_/เชียงใหม่,3826,2031,1795,1931
1186,ทต.เมืองที,TH/S_/32/ทต.เมืองที,TH/S_/32,1905,945,960,559
1187,ทต.เมืองนะ,TH/N_/เชียงใหม่/ทต.เมืองนะ,TH/N_/เชียงใหม่,37348,19024,18324,9198
1188,ทต.เมืองบัว,TH/NE/45/ทต.เมืองบัว,TH/NE/45,8458,4325,4133,2766
1189,ทต.เมืองพาน,TH/N_/57/ทต.เมืองพาน,TH/N_/57,6497,3473,3024,3500
1190,ทต.เมืองยาง,TH/NE/30/ทต.เมืองยาง,TH/NE/30,8131,4095,4036,2287
1191,ทต.เมืองรามันห์,TH/S_/95/ทต.เมืองรามันห์,TH/S_/95,5099,2580,2519,1865
1192,ทต.เมืองศรีไค,TH/NE/34/ทต.เมืองศรีไค,TH/NE/34,6161,3146,3015,3367
1193,ทต.เมืองสรวง,TH/NE/45/ทต.เมืองสรวง,TH/NE/45,9502,4792,4710,2827
1194,ทต.เมืองเก่า,TH/E_/25/ทต.เมืองเก่า,TH/E_/25,6584,3352,3232,4423
1195,ทต.เมืองเก่า,TH/CT/64/ทต.เมืองเก่า,TH/CT/64,7168,3829,3339,2581
1196,ทต.เมืองเก่า,TH/NE/ขอนแก่น/ทต.เมืองเก่า,TH/NE/ขอนแก่น,30996,16505,14491,17037
1197,ทต.เมืองแกลง,TH/E_/21/ทต.เมืองแกลง,TH/E_/21,18672,9793,8879,11600
1198,ทต.เมืองไพร,TH/NE/45/ทต.เมืองไพร,TH/NE/45,6250,3087,3163,1578
1199,ทต.เรณูนคร,TH/NE/48/ทต.เรณูนคร,TH/NE/48,4503,2386,2117,1691
1200,ทต.เลาขวัญ,TH/W_/71/ทต.เลาขวัญ,TH/W_/71,2629,1318,1311,1300
1201,ทต.เลิงนกทา,TH/NE/35/ทต.เลิงนกทา,TH/NE/35,2964,1529,1435,1083
1202,ทต.เวียง,TH/N_/56/ทต.เวียง,TH/N_/56,5484,2835,2649,2259
1203,ทต.เวียง,TH/N_/57/ทต.เวียง,TH/N_/57,9546,4837,4709,4198
1204,ทต.เวียงคำ,TH/NE/41/ทต.เวียงคำ,TH/NE/41,10490,5283,5207,3190
1205,ทต.เวียงคุก,TH/NE/43/ทต.เวียงคุก,TH/NE/43,5978,3111,2867,1888
1206,ทต.เวียงชัย,TH/N_/57/ทต.เวียงชัย,TH/N_/57,6790,3614,3176,3077
1207,ทต.เวียงต้า,TH/N_/54/ทต.เวียงต้า,TH/N_/54,6359,3151,3208,2435
1208,ทต.เวียงป่าเป้า,TH/N_/57/ทต.เวียงป่าเป้า,TH/N_/57,4547,2466,2081,2386
1209,ทต.เวียงฝาง,TH/N_/เชียงใหม่/ทต.เวียงฝาง,TH/N_/เชียงใหม่,8579,4481,4098,3937
1210,ทต.เวียงพร้าว,TH/N_/เชียงใหม่/ทต.เวียงพร้าว,TH/N_/เชียงใหม่,4821,2587,2234,2810
1211,ทต.เวียงพางคำ,TH/N_/57/ทต.เวียงพางคำ,TH/N_/57,22293,11934,10359,9670
1212,ทต.เวียงมอก,TH/N_/52/ทต.เวียงมอก,TH/N_/52,10277,5163,5114,3493
1213,ทต.เวียงยอง,TH/N_/51/ทต.เวียงยอง,TH/N_/51,6756,3616,3140,3329
1214,ทต.เวียงลอ,TH/N_/56/ทต.เวียงลอ,TH/N_/56,6183,3196,2987,2656
1215,ทต.เวียงสระ,TH/S_/84/ทต.เวียงสระ,TH/S_/84,9441,4960,4481,5762
1216,ทต.เวียงสา,TH/N_/55/ทต.เวียงสา,TH/N_/55,2862,1545,1317,1295
1217,ทต.เวียงเชียงของ,TH/N_/57/ทต.เวียงเชียงของ,TH/N_/57,3819,2027,1792,2342
1218,ทต.เวียงเชียงแสน,TH/N_/57/ทต.เวียงเชียงแสน,TH/N_/57,6497,3452,3045,3326
1219,ทต.เวียงเทิง,TH/N_/57/ทต.เวียงเทิง,TH/N_/57,5045,2708,2337,2744
1220,ทต.เสนางคนิคม,TH/NE/37/ทต.เสนางคนิคม,TH/NE/37,5763,2967,2796,1950
1221,ทต.เสม็ด,TH/E_/ชลบุรี/ทต.เสม็ด,TH/E_/ชลบุรี,22551,12377,10174,17440
1222,ทต.เสริมงาม,TH/N_/52/ทต.เสริมงาม,TH/N_/52,8331,4198,4133,2996
1223,ทต.เสลภูมิ,TH/NE/45/ทต.เสลภูมิ,TH/NE/45,13049,6734,6315,4975
1224,ทต.เสาธงหิน,TH/CT/12/ทต.เสาธงหิน,TH/CT/12,39574,21586,17988,26509
1225,ทต.เสาไห้,TH/CT/19/ทต.เสาไห้,TH/CT/19,3122,1622,1500,1441
1226,ทต.เสิงสาง,TH/NE/30/ทต.เสิงสาง,TH/NE/30,7649,3961,3688,3158
1227,ทต.เสือโฮก,TH/CT/18/ทต.เสือโฮก,TH/CT/18,7519,3873,3646,2430
1228,ทต.เหนือคลอง,TH/S_/81/ทต.เหนือคลอง,TH/S_/81,4292,2227,2065,2412
1229,ทต.เหมืองง่า,TH/N_/51/ทต.เหมืองง่า,TH/N_/51,15866,8631,7235,8194
1230,ทต.เหมืองใหม่,TH/CT/75/ทต.เหมืองใหม่,TH/CT/75,1974,1019,955,773
1231,ทต.เอราวัณ,TH/W_/71/ทต.เอราวัณ,TH/W_/71,960,488,472,723
1232,ทต.แกดำ,TH/NE/44/ทต.แกดำ,TH/NE/44,5344,2670,2674,1575
1233,ทต.แกลงกะเฉด,TH/E_/21/ทต.แกลงกะเฉด,TH/E_/21,7100,3683,3417,3279
1234,ทต.แก่งเสี้ยน,TH/W_/71/ทต.แก่งเสี้ยน,TH/W_/71,6335,3384,2951,3758
1235,ทต.แก่งเสือเต้น,TH/CT/16/ทต.แก่งเสือเต้น,TH/CT/16,2635,1346,1289,1050
1236,ทต.แก้งคร้อ,TH/NE/36/ทต.แก้งคร้อ,TH/NE/36,8626,4538,4088,4508
1237,ทต.แคนดง,TH/NE/31/ทต.แคนดง,TH/NE/31,5517,2764,2753,1885
1238,ทต.แคมป์สน,TH/CT/67/ทต.แคมป์สน,TH/CT/67,5420,2794,2626,3037
1239,ทต.แจ้ห่ม,TH/N_/52/ทต.แจ้ห่ม,TH/N_/52,3508,1835,1673,1670
1240,ทต.แชะ,TH/NE/30/ทต.แชะ,TH/NE/30,6092,3247,2845,3006
1241,ทต.แปลงยาว,TH/E_/24/ทต.แปลงยาว,TH/E_/24,6125,3140,2985,3465
1242,ทต.แพรกศรีราชา,TH/CT/18/ทต.แพรกศรีราชา,TH/CT/18,2508,1346,1162,1353
1243,ทต.แพรกษา,TH/CT/11/ทต.แพรกษา,TH/CT/11,26840,14243,12597,15544
1244,ทต.แม่กา,TH/N_/56/ทต.แม่กา,TH/N_/56,13120,6871,6249,6743
1245,ทต.แม่กุ,TH/W_/63/ทต.แม่กุ,TH/W_/63,6504,3302,3202,2861
1246,ทต.แม่ขรี,TH/S_/93/ทต.แม่ขรี,TH/S_/93,6239,3244,2995,3398
1247,ทต.แม่ขะจาน,TH/N_/57/ทต.แม่ขะจาน,TH/N_/57,2926,1557,1369,1579
1248,ทต.แม่คำ,TH/N_/57/ทต.แม่คำ,TH/N_/57,4578,2417,2161,2153
1249,ทต.แม่คำมี,TH/N_/54/ทต.แม่คำมี,TH/N_/54,7212,3681,3531,2706
1250,ทต.แม่จะเรา,TH/W_/63/ทต.แม่จะเรา,TH/W_/63,5311,2721,2590,2153
1251,ทต.แม่จัน,TH/N_/57/ทต.แม่จัน,TH/N_/57,3658,1954,1704,2420
1252,ทต.แม่จั๊วะ,TH/N_/54/ทต.แม่จั๊วะ,TH/N_/54,3789,1968,1821,1556
1253,ทต.แม่ตืน,TH/N_/51/ทต.แม่ตืน,TH/N_/51,3458,1803,1655,1349
1254,ทต.แม่ต้าน,TH/W_/63/ทต.แม่ต้าน,TH/W_/63,3832,1936,1896,1377
1255,ทต.แม่ทะ,TH/N_/52/ทต.แม่ทะ,TH/N_/52,6587,3332,3255,2955
1256,ทต.แม่ปั๋ง,TH/N_/เชียงใหม่/ทต.แม่ปั๋ง,TH/N_/เชียงใหม่,6136,3090,3046,2605
1257,ทต.แม่ปาน,TH/N_/54/ทต.แม่ปาน,TH/N_/54,2927,1445,1482,1140
1258,ทต.แม่ปืม,TH/N_/56/ทต.แม่ปืม,TH/N_/56,9054,4619,4435,3400
1259,ทต.แม่ปุ,TH/N_/52/ทต.แม่ปุ,TH/N_/52,3869,2025,1844,1333
1260,ทต.แม่พริก,TH/N_/52/ทต.แม่พริก,TH/N_/52,2605,1349,1256,1111
1261,ทต.แม่ยาว,TH/N_/57/ทต.แม่ยาว,TH/N_/57,21627,10927,10700,8977
1262,ทต.แม่ระมาด,TH/W_/63/ทต.แม่ระมาด,TH/W_/63,3991,2000,1991,1846
1263,ทต.แม่ริม,TH/N_/เชียงใหม่/ทต.แม่ริม,TH/N_/เชียงใหม่,9448,5032,4416,5752
1264,ทต.แม่ลานนา,TH/N_/54/ทต.แม่ลานนา,TH/N_/54,6542,3347,3195,2615
1265,ทต.แม่ลาน้อย,TH/N_/58/ทต.แม่ลาน้อย,TH/N_/58,3615,1818,1797,1778
1266,ทต.แม่ลาว,TH/N_/57/ทต.แม่ลาว,TH/N_/57,1816,958,858,803
1267,ทต.แม่วาง,TH/N_/เชียงใหม่/ทต.แม่วาง,TH/N_/เชียงใหม่,4579,2427,2152,2186
1268,ทต.แม่สรวย,TH/N_/57/ทต.แม่สรวย,TH/N_/57,1482,764,718,1093
1269,ทต.แม่สะเรียง,TH/N_/58/ทต.แม่สะเรียง,TH/N_/58,2851,1505,1346,1945
1270,ทต.แม่สาย,TH/N_/57/ทต.แม่สาย,TH/N_/57,28321,15125,13196,13624
1271,ทต.แม่หล่าย,TH/N_/54/ทต.แม่หล่าย,TH/N_/54,4418,2371,2047,1965
1272,ทต.แม่อาย,TH/N_/เชียงใหม่/ทต.แม่อาย,TH/N_/เชียงใหม่,10634,5481,5153,4853
1273,ทต.แม่เมาะ,TH/N_/52/ทต.แม่เมาะ,TH/N_/52,15399,7837,7562,8627
1274,ทต.แม่แจ่ม,TH/N_/เชียงใหม่/ทต.แม่แจ่ม,TH/N_/เชียงใหม่,2627,1331,1296,1606
1275,ทต.แม่แฝก,TH/N_/เชียงใหม่/ทต.แม่แฝก,TH/N_/เชียงใหม่,9061,4806,4255,3889
1276,ทต.แม่แรง,TH/N_/51/ทต.แม่แรง,TH/N_/51,7086,3681,3405,2886
1277,ทต.แม่ใจ,TH/N_/56/ทต.แม่ใจ,TH/N_/56,5006,2618,2388,2152
1278,ทต.แวงน่าง,TH/NE/44/ทต.แวงน่าง,TH/NE/44,5600,2891,2709,2178
1279,ทต.แวงน้อย,TH/NE/ขอนแก่น/ทต.แวงน้อย,TH/NE/ขอนแก่น,3072,1604,1468,1303
1280,ทต.แวงใหญ่,TH/NE/ขอนแก่น/ทต.แวงใหญ่,TH/NE/ขอนแก่น,5142,2661,2481,1744
1281,ทต.แว้ง,TH/S_/96/ทต.แว้ง,TH/S_/96,5352,2741,2611,1665
1282,ทต.แสงสว่าง,TH/NE/41/ทต.แสงสว่าง,TH/NE/41,4016,2003,2013,968
1283,ทต.แสนตุ้ง,TH/E_/23/ทต.แสนตุ้ง,TH/E_/23,3245,1640,1605,2354
1284,ทต.แสนสุข,TH/NE/34/ทต.แสนสุข,TH/NE/34,24737,11111,13626,10917
1285,ทต.แสวงหา,TH/CT/15/ทต.แสวงหา,TH/CT/15,3250,1655,1595,1258
1286,ทต.แหลมงอบ,TH/E_/23/ทต.แหลมงอบ,TH/E_/23,1811,925,886,718
1287,ทต.แหลมฟ้าผ่า,TH/CT/11/ทต.แหลมฟ้าผ่า,TH/CT/11,21309,10960,10349,9008
1288,ทต.แหลมสัก,TH/S_/81/ทต.แหลมสัก,TH/S_/81,4115,2046,2069,1233
1289,ทต.โกตาบารู,TH/S_/95/ทต.โกตาบารู,TH/S_/95,5877,2978,2899,1539
1290,ทต.โกรกพระ,TH/CT/60/ทต.โกรกพระ,TH/CT/60,2285,1191,1094,997
1291,ทต.โกสุมพิสัย,TH/NE/44/ทต.โกสุมพิสัย,TH/NE/44,9226,4817,4409,4204
1292,ทต.โคกกรวด,TH/NE/30/ทต.โคกกรวด,TH/NE/30,7142,3792,3350,4376
1293,ทต.โคกกลอย,TH/S_/82/ทต.โคกกลอย,TH/S_/82,3535,1838,1697,1710
1294,ทต.โคกคราม,TH/CT/72/ทต.โคกคราม,TH/CT/72,1537,813,724,862
1295,ทต.โคกตูม,TH/CT/16/ทต.โคกตูม,TH/CT/16,29571,14975,14596,11496
1296,ทต.โคกปีบ,TH/E_/25/ทต.โคกปีบ,TH/E_/25,5892,3088,2804,2308
1297,ทต.โคกพระ,TH/NE/44/ทต.โคกพระ,TH/NE/44,3416,1788,1628,1459
1298,ทต.โคกมะกอก,TH/E_/25/ทต.โคกมะกอก,TH/E_/25,2185,1145,1040,813
1299,ทต.โคกม่วง,TH/S_/90/ทต.โคกม่วง,TH/S_/90,7713,3494,4219,2734
1300,ทต.โคกม่วง,TH/S_/93/ทต.โคกม่วง,TH/S_/93,10386,5272,5114,3623
1301,ทต.โคกล่าม,TH/NE/45/ทต.โคกล่าม,TH/NE/45,7403,3728,3675,2063
1302,ทต.โคกศรี,TH/NE/46/ทต.โคกศรี,TH/NE/46,3175,1622,1553,1261
1303,ทต.โคกสวาย,TH/NE/30/ทต.โคกสวาย,TH/NE/30,5297,2715,2582,1773
1304,ทต.โคกสะอาด,TH/CT/67/ทต.โคกสะอาด,TH/CT/67,6551,3294,3257,2165
1305,ทต.โคกสำโรง,TH/CT/16/ทต.โคกสำโรง,TH/CT/16,5845,3047,2798,2434
1306,ทต.โคกสูง,TH/NE/ขอนแก่น/ทต.โคกสูง,TH/NE/ขอนแก่น,8874,4338,4536,2418
1307,ทต.โคกสูงสัมพันธ์,TH/NE/ขอนแก่น/ทต.โคกสูงสัมพันธ์,TH/NE/ขอนแก่น,4377,2306,2071,1301
1308,ทต.โคกโพธิ์,TH/S_/94/ทต.โคกโพธิ์,TH/S_/94,3356,1763,1593,1790
1309,ทต.โชคชัย,TH/NE/30/ทต.โชคชัย,TH/NE/30,12696,6659,6037,5507
1310,ทต.โซ่พิสัย,TH/NE/38/ทต.โซ่พิสัย,TH/NE/38,6615,3311,3304,2558
1311,ทต.โนนดินแดง,TH/NE/31/ทต.โนนดินแดง,TH/NE/31,9545,4856,4689,3576
1312,ทต.โนนตาล,TH/NE/45/ทต.โนนตาล,TH/NE/45,5227,2603,2624,1423
1313,ทต.โนนท่อน,TH/NE/ขอนแก่น/ทต.โนนท่อน,TH/NE/ขอนแก่น,9819,4977,4842,3104
1314,ทต.โนนบุรี,TH/NE/46/ทต.โนนบุรี,TH/NE/46,5223,2725,2498,1976
1315,ทต.โนนปอแดง,TH/NE/42/ทต.โนนปอแดง,TH/NE/42,11125,5542,5583,3460
1316,ทต.โนนศิลา,TH/NE/ขอนแก่น/ทต.โนนศิลา,TH/NE/ขอนแก่น,5600,2775,2825,1781
1317,ทต.โนนสมบูรณ์,TH/NE/30/ทต.โนนสมบูรณ์,TH/NE/30,5849,2938,2911,1810
1318,ทต.โนนสมบูรณ์,TH/NE/ขอนแก่น/ทต.โนนสมบูรณ์,TH/NE/ขอนแก่น,5925,2976,2949,1759
1319,ทต.โนนสว่าง,TH/NE/38/ทต.โนนสว่าง,TH/NE/38,6906,3492,3414,2342
1320,ทต.โนนสะอาด,TH/NE/41/ทต.โนนสะอาด,TH/NE/41,4489,2284,2205,1738
1321,ทต.โนนสัง,TH/NE/39/ทต.โนนสัง,TH/NE/39,8422,4277,4145,2768
1322,ทต.โนนสุวรรณ,TH/NE/31/ทต.โนนสุวรรณ,TH/NE/31,3319,1691,1628,1065
1323,ทต.โนนสูง,TH/NE/30/ทต.โนนสูง,TH/NE/30,9649,5016,4633,3967
1324,ทต.โนนสูงเปลือย,TH/NE/39/ทต.โนนสูงเปลือย,TH/NE/39,4747,2473,2274,2603
1325,ทต.โนนหัน,TH/NE/ขอนแก่น/ทต.โนนหัน,TH/NE/ขอนแก่น,4681,2457,2224,1525
1326,ทต.โนนแดง,TH/NE/30/ทต.โนนแดง,TH/NE/30,4318,2214,2104,1561
1327,ทต.โนนไทย,TH/NE/30/ทต.โนนไทย,TH/NE/30,3119,1664,1455,1374
1328,ทต.โป่ง,TH/E_/ชลบุรี/ทต.โป่ง,TH/E_/ชลบุรี,10532,5488,5044,6330
1329,ทต.โป่งน้ำร้อน,TH/E_/22/ทต.โป่งน้ำร้อน,TH/E_/22,9111,4203,4908,4209
1330,ทต.โพทะเล,TH/CT/66/ทต.โพทะเล,TH/CT/66,2494,1282,1212,1015
1331,ทต.โพธิ์กระสังข์,TH/NE/33/ทต.โพธิ์กระสังข์,TH/NE/33,9198,4575,4623,2048
1332,ทต.โพธิ์กลาง,TH/NE/30/ทต.โพธิ์กลาง,TH/NE/30,29308,13917,15391,13214
1333,ทต.โพธิ์ชัย,TH/NE/43/ทต.โพธิ์ชัย,TH/NE/43,7700,3982,3718,3710
1334,ทต.โพธิ์ชัย,TH/NE/45/ทต.โพธิ์ชัย,TH/NE/45,6742,3386,3356,1723
1335,ทต.โพธิ์ทอง,TH/CT/15/ทต.โพธิ์ทอง,TH/CT/15,4273,2261,2012,1829
1336,ทต.โพธิ์ประทับช้าง,TH/CT/66/ทต.โพธิ์ประทับช้าง,TH/CT/66,9641,4992,4649,3575
1337,ทต.โพธิ์พระยา,TH/CT/72/ทต.โพธิ์พระยา,TH/CT/72,3387,1865,1522,1710
1338,ทต.โพธิ์พิทักษ์,TH/CT/18/ทต.โพธิ์พิทักษ์,TH/CT/18,1585,828,757,571
1339,ทต.โพธิ์ไทร,TH/NE/34/ทต.โพธิ์ไทร,TH/NE/34,3058,1551,1507,1169
1340,ทต.โพน,TH/NE/46/ทต.โพน,TH/NE/46,3813,1926,1887,1091
1341,ทต.โพนงาม,TH/NE/34/ทต.โพนงาม,TH/NE/34,9077,4582,4495,3155
1342,ทต.โพนทราย,TH/NE/45/ทต.โพนทราย,TH/NE/45,5586,2804,2782,1939
1343,ทต.โพนทอง,TH/NE/45/ทต.โพนทอง,TH/NE/45,11404,5800,5604,4935
1344,ทต.โพนพิสัย,TH/NE/43/ทต.โพนพิสัย,TH/NE/43,2650,1324,1326,1229
1345,ทต.โพนสวรรค์,TH/NE/48/ทต.โพนสวรรค์,TH/NE/48,5369,2681,2688,1820
1346,ทต.โพนสา,TH/NE/43/ทต.โพนสา,TH/NE/43,3769,2000,1769,1135
1347,ทต.โพนสูง,TH/NE/41/ทต.โพนสูง,TH/NE/41,7402,3654,3748,1855
1348,ทต.โพรงมะเดื่อ,TH/CT/73/ทต.โพรงมะเดื่อ,TH/CT/73,10820,5656,5164,4178
1349,ทต.โพสังโฆ,TH/CT/17/ทต.โพสังโฆ,TH/CT/17,2046,1080,966,837
1350,ทต.โพหัก,TH/W_/70/ทต.โพหัก,TH/W_/70,10513,5413,5100,3677
1351,ทต.โรงช้าง,TH/CT/14/ทต.โรงช้าง,TH/CT/14,6320,3304,3016,2466
1352,ทต.ในเมือง,TH/N_/53/ทต.ในเมือง,TH/N_/53,1850,997,853,1010
1353,ทต.ในเมือง,TH/CT/64/ทต.ในเมือง,TH/CT/64,8148,4196,3952,3350
1354,ทต.ใหม่,TH/NE/30/ทต.ใหม่,TH/NE/30,12746,6421,6325,3472
1355,ทต.ไชยปราการ,TH/N_/เชียงใหม่/ทต.ไชยปราการ,TH/N_/เชียงใหม่,15829,8284,7545,6594
1356,ทต.ไชยวาน,TH/NE/41/ทต.ไชยวาน,TH/NE/41,8297,4248,4049,2351
1357,ทต.ไชโย,TH/CT/15/ทต.ไชโย,TH/CT/15,12700,6577,6123,4156
1358,ทต.ไทรงาม,TH/CT/62/ทต.ไทรงาม,TH/CT/62,4994,2601,2393,2458
1359,ทต.ไทรน้อย,TH/CT/12/ทต.ไทรน้อย,TH/CT/12,2511,1238,1273,1055
1360,ทต.ไทรย้อย,TH/CT/65/ทต.ไทรย้อย,TH/CT/65,8542,4315,4227,3110
1361,ทต.ไทรโยง-ไชยวาล,TH/NE/30/ทต.ไทรโยง-ไชยวาล,TH/NE/30,3655,1854,1801,1147
1362,ทต.ไผ่กองดิน,TH/CT/72/ทต.ไผ่กองดิน,TH/CT/72,1723,882,841,616
1363,ทต.ไผ่ต่ำ,TH/CT/19/ทต.ไผ่ต่ำ,TH/CT/19,4022,2042,1980,2099
1364,ทต.ไพรบึง,TH/NE/33/ทต.ไพรบึง,TH/NE/33,10890,5436,5454,2883
1365,ทต.ไพศาลี,TH/CT/60/ทต.ไพศาลี,TH/CT/60,10332,5443,4889,4946
1366,ทต.ไม้งาม,TH/W_/63/ทต.ไม้งาม,TH/W_/63,11762,5232,6530,6340
1367,ทต.ไม้ยา,TH/N_/57/ทต.ไม้ยา,TH/N_/57,10630,5313,5317,3749
1368,ทต.ไม้เรียง,TH/S_/นครศรีธรรมราช/ทต.ไม้เรียง,TH/S_/นครศรีธรรมราช,2395,1244,1151,1252
1369,ทต.ไร่เก่า,TH/W_/ประจวบคีรีขันธ์/ทต.ไร่เก่า,TH/W_/ประจวบคีรีขันธ์,10664,5390,5274,4140
1370,ทต.ไร่ใหม่,TH/W_/ประจวบคีรีขันธ์/ทต.ไร่ใหม่,TH/W_/ประจวบคีรีขันธ์,7733,4003,3730,2856
1371,ทน.ขอนแก่น,TH/NE/ขอนแก่น/ทน.ขอนแก่น,TH/NE/ขอนแก่น,110615,58459,52156,66498
1372,ทน.ตรัง,TH/S_/92/ทน.ตรัง,TH/S_/92,56893,30710,26183,25371
1373,ทน.นครปฐม,TH/CT/73/ทน.นครปฐม,TH/CT/73,72753,38308,34445,37774
1374,ทน.นครราชสีมา,TH/NE/30/ทน.นครราชสีมา,TH/NE/30,122730,65525,57205,72081
1375,ทน.นครศรีธรรมราช,TH/S_/นครศรีธรรมราช/ทน.นครศรีธรรมราช,TH/S_/นครศรีธรรมราช,100416,53005,47411,46553
1376,ทน.นครสวรรค์,TH/CT/60/ทน.นครสวรรค์,TH/CT/60,81239,42697,38542,42683
1377,ทน.นนทบุรี,TH/CT/12/ทน.นนทบุรี,TH/CT/12,251026,133308,117718,157944
1378,ทน.ปากเกร็ด,TH/CT/12/ทน.ปากเกร็ด,TH/CT/12,189458,101856,87602,131416
1379,ทน.พระนครศรีอยุธยา,TH/CT/14/ทน.พระนครศรีอยุธยา,TH/CT/14,49208,25785,23423,20332
1380,ทน.พิษณุโลก,TH/CT/65/ทน.พิษณุโลก,TH/CT/65,64068,34969,29099,36826
1381,ทน.ภูเก็ต,TH/S_/83/ทน.ภูเก็ต,TH/S_/83,77778,41951,35827,26666
1382,ทน.ยะลา,TH/S_/95/ทน.ยะลา,TH/S_/95,59983,31606,28377,28297
1383,ทน.ระยอง,TH/E_/21/ทน.ระยอง,TH/E_/21,62384,33128,29256,37658
1384,ทน.รังสิต,TH/CT/ปทุมธานี/ทน.รังสิต,TH/CT/ปทุมธานี,84268,45163,39105,56127
1385,ทน.ลำปาง,TH/N_/52/ทน.ลำปาง,TH/N_/52,50967,28003,22964,29304
1386,ทน.สกลนคร,TH/NE/47/ทน.สกลนคร,TH/NE/47,51331,26279,25052,28316
1387,ทน.สงขลา,TH/S_/90/ทน.สงขลา,TH/S_/90,60021,31115,28906,27527
1388,ทน.สมุทรปราการ,TH/CT/11/ทน.สมุทรปราการ,TH/CT/11,49604,25510,24094,20657
1389,ทน.สมุทรสาคร,TH/CT/74/ทน.สมุทรสาคร,TH/CT/74,65409,33169,32240,18925
1390,ทน.สุราษฎร์ธานี,TH/S_/84/ทน.สุราษฎร์ธานี,TH/S_/84,131599,68995,62604,75558
1391,ทน.หาดใหญ่,TH/S_/90/ทน.หาดใหญ่,TH/S_/90,149459,80423,69036,68333
1392,ทน.อุดรธานี,TH/NE/41/ทน.อุดรธานี,TH/NE/41,120202,62804,57398,61123
1393,ทน.อุบลราชธานี,TH/NE/34/ทน.อุบลราชธานี,TH/NE/34,72855,39050,33805,32040
1394,ทน.อ้อมน้อย,TH/CT/74/ทน.อ้อมน้อย,TH/CT/74,53822,28197,25625,49114
1395,ทน.เกาะสมุย,TH/S_/84/ทน.เกาะสมุย,TH/S_/84,68994,35729,33265,55845
1396,ทน.เจ้าพระยาสุรศักดิ์,TH/E_/ชลบุรี/ทน.เจ้าพระยาสุรศักดิ์,TH/E_/ชลบุรี,146474,75160,71314,101394
1397,ทน.เชียงราย,TH/N_/57/ทน.เชียงราย,TH/N_/57,77545,40611,36934,50608
1398,ทน.เชียงใหม่,TH/N_/เชียงใหม่/ทน.เชียงใหม่,TH/N_/เชียงใหม่,122627,65314,57313,90147
1399,ทน.แม่สอด,TH/W_/63/ทน.แม่สอด,TH/W_/63,41581,20911,20670,19482
1400,ทน.แหลมฉบัง,TH/E_/ชลบุรี/ทน.แหลมฉบัง,TH/E_/ชลบุรี,89457,45483,43974,80380
1401,ทม.กระทุ่มล้ม,TH/CT/73/ทม.กระทุ่มล้ม,TH/CT/73,28221,15124,13097,18347
1402,ทม.กระทุ่มแบน,TH/CT/74/ทม.กระทุ่มแบน,TH/CT/74,27556,14112,13444,6403
1403,ทม.กระนวน,TH/NE/ขอนแก่น/ทม.กระนวน,TH/NE/ขอนแก่น,10046,5223,4823,4505
1404,ทม.กระบี่,TH/S_/81/ทม.กระบี่,TH/S_/81,32536,17429,15107,17608
1405,ทม.กะทู้,TH/S_/83/ทม.กะทู้,TH/S_/83,30263,16208,14055,21292
1406,ทม.กันตัง,TH/S_/92/ทม.กันตัง,TH/S_/92,11815,6009,5806,5033
1407,ทม.กันทรลักษ์,TH/NE/33/ทม.กันทรลักษ์,TH/NE/33,17783,9193,8590,7510
1408,ทม.กาญจนบุรี,TH/W_/71/ทม.กาญจนบุรี,TH/W_/71,26937,14231,12706,15913
1409,ทม.กาฬสินธุ์,TH/NE/46/ทม.กาฬสินธุ์,TH/NE/46,32482,16962,15520,15878
1410,ทม.กำแพงเพชร,TH/CT/62/ทม.กำแพงเพชร,TH/CT/62,28378,15083,13295,16231
1411,ทม.กุฉินารายณ์,TH/NE/46/ทม.กุฉินารายณ์,TH/NE/46,11333,5808,5525,4893
1412,ทม.ขลุง,TH/E_/22/ทม.ขลุง,TH/E_/22,10735,5697,5038,4271
1413,ทม.คลองหลวง,TH/CT/ปทุมธานี/ทม.คลองหลวง,TH/CT/ปทุมธานี,64649,34133,30516,51658
1414,ทม.คลองแห,TH/S_/90/ทม.คลองแห,TH/S_/90,40666,21540,19126,20846
1415,ทม.ควนลัง,TH/S_/90/ทม.ควนลัง,TH/S_/90,49321,26209,23112,25502
1416,ทม.คอหงส์,TH/S_/90/ทม.คอหงส์,TH/S_/90,46184,24047,22137,29265
1417,ทม.คูคต,TH/CT/ปทุมธานี/ทม.คูคต,TH/CT/ปทุมธานี,43941,22708,21233,26172
1418,ทม.จันทนิมิต,TH/E_/22/ทม.จันทนิมิต,TH/E_/22,12270,6486,5784,7783
1419,ทม.จันทบุรี,TH/E_/22/ทม.จันทบุรี,TH/E_/22,22120,11596,10524,14576
1420,ทม.ฉะเชิงเทรา,TH/E_/24/ทม.ฉะเชิงเทรา,TH/E_/24,38184,20132,18052,22048
1421,ทม.ชลบุรี,TH/E_/ชลบุรี/ทม.ชลบุรี,TH/E_/ชลบุรี,25434,13409,12025,12563
1422,ทม.ชะอำ,TH/W_/76/ทม.ชะอำ,TH/W_/76,40003,20740,19263,45786
1423,ทม.ชัยนาท,TH/CT/18/ทม.ชัยนาท,TH/CT/18,11675,6301,5374,7441
1424,ทม.ชัยภูมิ,TH/NE/36/ทม.ชัยภูมิ,TH/NE/36,35901,18850,17051,20764
1425,ทม.ชุมพร,TH/S_/86/ทม.ชุมพร,TH/S_/86,33738,18056,15682,19905
1426,ทม.ชุมแพ,TH/NE/ขอนแก่น/ทม.ชุมแพ,TH/NE/ขอนแก่น,30992,16046,14946,15429
1427,ทม.ชุมแสง,TH/CT/60/ทม.ชุมแสง,TH/CT/60,7563,4026,3537,3611
1428,ทม.ดอกคำใต้,TH/N_/56/ทม.ดอกคำใต้,TH/N_/56,12656,6792,5864,5348
1429,ทม.ดอนสัก,TH/S_/84/ทม.ดอนสัก,TH/S_/84,12098,6215,5883,5734
1430,ทม.ตราด,TH/E_/23/ทม.ตราด,TH/E_/23,9746,5057,4689,5523
1431,ทม.ตะกั่วป่า,TH/S_/82/ทม.ตะกั่วป่า,TH/S_/82,8229,4267,3962,2708
1432,ทม.ตะพานหิน,TH/CT/66/ทม.ตะพานหิน,TH/CT/66,13536,7224,6312,6249
1433,ทม.ตะลุบัน,TH/S_/94/ทม.ตะลุบัน,TH/S_/94,14484,7351,7133,4420
1434,ทม.ตาก,TH/W_/63/ทม.ตาก,TH/W_/63,16079,8472,7607,7439
1435,ทม.ตากใบ,TH/S_/96/ทม.ตากใบ,TH/S_/96,19686,10129,9557,5659
1436,ทม.ตาคลี,TH/CT/60/ทม.ตาคลี,TH/CT/60,23192,12080,11112,9902
1437,ทม.ต้นเปา,TH/N_/เชียงใหม่/ทม.ต้นเปา,TH/N_/เชียงใหม่,19263,10473,8790,12944
1438,ทม.ทับกวาง,TH/CT/19/ทม.ทับกวาง,TH/CT/19,19714,9866,9848,9568
1439,ทม.ทุ่งตำเสา,TH/S_/90/ทม.ทุ่งตำเสา,TH/S_/90,16941,8679,8262,6032
1440,ทม.ทุ่งสง,TH/S_/นครศรีธรรมราช/ทม.ทุ่งสง,TH/S_/นครศรีธรรมราช,30002,16235,13767,11362
1441,ทม.ท่าข้าม,TH/S_/84/ทม.ท่าข้าม,TH/S_/84,18905,9676,9229,9018
1442,ทม.ท่าช้าง,TH/E_/22/ทม.ท่าช้าง,TH/E_/22,13851,7507,6344,10442
1443,ทม.ท่าบ่อ,TH/NE/43/ทม.ท่าบ่อ,TH/NE/43,17390,8922,8468,7235
1444,ทม.ท่าผา,TH/W_/70/ทม.ท่าผา,TH/W_/70,20156,10392,9764,8155
1445,ทม.ท่าเรือพระแท่น,TH/W_/71/ทม.ท่าเรือพระแท่น,TH/W_/71,11177,5886,5291,5031
1446,ทม.ท่าโขลง,TH/CT/ปทุมธานี/ทม.ท่าโขลง,TH/CT/ปทุมธานี,77243,42166,35077,56320
1447,ทม.ท่าใหม่,TH/E_/22/ทม.ท่าใหม่,TH/E_/22,10130,5406,4724,4549
1448,ทม.นครนายก,TH/CT/26/ทม.นครนายก,TH/CT/26,15995,8383,7612,8479
1449,ทม.นครพนม,TH/NE/48/ทม.นครพนม,TH/NE/48,26093,13803,12290,14957
1450,ทม.นราธิวาส,TH/S_/96/ทม.นราธิวาส,TH/S_/96,40133,20460,19673,15736
1451,ทม.นางรอง,TH/NE/31/ทม.นางรอง,TH/NE/31,20734,10966,9768,11298
1452,ทม.นาสาร,TH/S_/84/ทม.นาสาร,TH/S_/84,19199,9840,9359,8080
1453,ทม.น่าน,TH/N_/55/ทม.น่าน,TH/N_/55,19506,9829,9677,10772
1454,ทม.บัวใหญ่,TH/NE/30/ทม.บัวใหญ่,TH/NE/30,13505,7031,6474,7067
1455,ทม.บางกรวย,TH/CT/12/ทม.บางกรวย,TH/CT/12,44527,24054,20473,22035
1456,ทม.บางกะดี,TH/CT/ปทุมธานี/ทม.บางกะดี,TH/CT/ปทุมธานี,14357,7556,6801,7072
1457,ทม.บางบัวทอง,TH/CT/12/ทม.บางบัวทอง,TH/CT/12,51441,27778,23663,25771
1458,ทม.บางมูลนาก,TH/CT/66/ทม.บางมูลนาก,TH/CT/66,8247,4317,3930,3680
1459,ทม.บางระจัน,TH/CT/17/ทม.บางระจัน,TH/CT/17,13937,7391,6546,5624
1460,ทม.บางศรีเมือง,TH/CT/12/ทม.บางศรีเมือง,TH/CT/12,33005,17726,15279,13190
1461,ทม.บึงกาฬ,TH/NE/38/ทม.บึงกาฬ,TH/NE/38,20062,10118,9944,11011
1462,ทม.บึงยี่โถ,TH/CT/ปทุมธานี/ทม.บึงยี่โถ,TH/CT/ปทุมธานี,32988,17909,15079,15387
1463,ทม.บุรีรัมย์,TH/NE/31/ทม.บุรีรัมย์,TH/NE/31,25087,13165,11922,14464
1464,ทม.บ้านฉาง,TH/E_/21/ทม.บ้านฉาง,TH/E_/21,31182,15939,15243,20588
1465,ทม.บ้านดุง,TH/NE/41/ทม.บ้านดุง,TH/NE/41,15451,8016,7435,6278
1466,ทม.บ้านทุ่ม,TH/NE/ขอนแก่น/ทม.บ้านทุ่ม,TH/NE/ขอนแก่น,18604,9623,8981,8064
1467,ทม.บ้านบึง,TH/E_/ชลบุรี/ทม.บ้านบึง,TH/E_/ชลบุรี,20891,11037,9854,10372
1468,ทม.บ้านพรุ,TH/S_/90/ทม.บ้านพรุ,TH/S_/90,26131,13690,12441,12353
1469,ทม.บ้านสวน,TH/E_/ชลบุรี/ทม.บ้านสวน,TH/E_/ชลบุรี,68790,34693,34097,45512
1470,ทม.บ้านหมี่,TH/CT/16/ทม.บ้านหมี่,TH/CT/16,3230,1696,1534,1441
1471,ทม.บ้านโป่ง,TH/W_/70/ทม.บ้านโป่ง,TH/W_/70,16195,8650,7545,8256
1472,ทม.บ้านไผ่,TH/NE/ขอนแก่น/ทม.บ้านไผ่,TH/NE/ขอนแก่น,27497,14273,13224,12697
1473,ทม.ปทุมธานี,TH/CT/ปทุมธานี/ทม.ปทุมธานี,TH/CT/ปทุมธานี,23528,12448,11080,9506
1474,ทม.ประจวบคีรีขันธ์,TH/W_/ประจวบคีรีขันธ์/ทม.ประจวบคีรีขันธ์,TH/W_/ประจวบคีรีขันธ์,18174,9761,8413,10866
1475,ทม.ปราจีนบุรี,TH/E_/25/ทม.ปราจีนบุรี,TH/E_/25,16651,8911,7740,8879
1476,ทม.ปัตตานี,TH/S_/94/ทม.ปัตตานี,TH/S_/94,46028,23690,22338,16163
1477,ทม.ปากช่อง,TH/NE/30/ทม.ปากช่อง,TH/NE/30,33700,17813,15887,18716
1478,ทม.ปากน้ำสมุทรปราการ,TH/CT/11/ทม.ปากน้ำสมุทรปราการ,TH/CT/11,36425,19367,17058,15418
1479,ทม.ปากพนัง,TH/S_/นครศรีธรรมราช/ทม.ปากพนัง,TH/S_/นครศรีธรรมราช,19437,9836,9601,7928
1480,ทม.ปากแพรก,TH/W_/71/ทม.ปากแพรก,TH/W_/71,27050,14306,12744,15403
1481,ทม.ปางมะค่า,TH/CT/62/ทม.ปางมะค่า,TH/CT/62,17671,8820,8851,6763
1482,ทม.ปาดังเบซาร์,TH/S_/90/ทม.ปาดังเบซาร์,TH/S_/90,15938,8177,7761,6168
1483,ทม.ปู่เจ้าสมิงพราย,TH/CT/11/ทม.ปู่เจ้าสมิงพราย,TH/CT/11,71643,36903,34740,35651
1484,ทม.ป่าตอง,TH/S_/83/ทม.ป่าตอง,TH/S_/83,20122,10339,9783,16472
1485,ทม.ผักไห่,TH/CT/14/ทม.ผักไห่,TH/CT/14,9573,4957,4616,4375
1486,ทม.พนัสนิคม,TH/E_/ชลบุรี/ทม.พนัสนิคม,TH/E_/ชลบุรี,10075,5455,4620,4989
1487,ทม.พระประแดง,TH/CT/11/ทม.พระประแดง,TH/CT/11,9071,4699,4372,2182
1488,ทม.พระพุทธบาท,TH/CT/19/ทม.พระพุทธบาท,TH/CT/19,33458,17745,15713,13230
1489,ทม.พะเยา,TH/N_/56/ทม.พะเยา,TH/N_/56,16332,8752,7580,8213
1490,ทม.พังงา,TH/S_/82/ทม.พังงา,TH/S_/82,10329,5292,5037,5897
1491,ทม.พัทลุง,TH/S_/93/ทม.พัทลุง,TH/S_/93,32423,17513,14910,16063
1492,ทม.พิจิตร,TH/CT/66/ทม.พิจิตร,TH/CT/66,21182,11248,9934,12478
1493,ทม.พิชัย,TH/N_/52/ทม.พิชัย,TH/N_/52,13161,6996,6165,6405
1494,ทม.พิบูลมังสาหาร,TH/NE/34/ทม.พิบูลมังสาหาร,TH/NE/34,10500,5434,5066,4517
1495,ทม.พิมลราช,TH/CT/12/ทม.พิมลราช,TH/CT/12,47874,25747,22127,23331
1496,ทม.มหาสารคาม,TH/NE/44/ทม.มหาสารคาม,TH/NE/44,49780,28176,21604,21442
1497,ทม.มาบตาพุด,TH/E_/21/ทม.มาบตาพุด,TH/E_/21,71932,35848,36084,59696
1498,ทม.มุกดาหาร,TH/NE/49/ทม.มุกดาหาร,TH/NE/49,33111,17069,16042,15869
1499,ทม.ยโสธร,TH/NE/35/ทม.ยโสธร,TH/NE/35,20232,10434,9798,9098
1500,ทม.ระนอง,TH/S_/85/ทม.ระนอง,TH/S_/85,19285,9801,9484,8186
1501,ทม.ราชบุรี,TH/W_/70/ทม.ราชบุรี,TH/W_/70,34713,18765,15948,16379
1502,ทม.ร้อยเอ็ด,TH/NE/45/ทม.ร้อยเอ็ด,TH/NE/45,35803,18957,16846,16762
1503,ทม.ลพบุรี,TH/CT/16/ทม.ลพบุรี,TH/CT/16,21779,11196,10583,12683
1504,ทม.ลัดหลวง,TH/CT/11/ทม.ลัดหลวง,TH/CT/11,70896,36937,33959,37404
1505,ทม.ลาดสวาย,TH/CT/ปทุมธานี/ทม.ลาดสวาย,TH/CT/ปทุมธานี,67256,35774,31482,39485
1506,ทม.ลำตาเสา,TH/CT/14/ทม.ลำตาเสา,TH/CT/14,21357,10956,10401,9689
1507,ทม.ลำพูน,TH/N_/51/ทม.ลำพูน,TH/N_/51,11728,6372,5356,7171
1508,ทม.ลำสามแก้ว,TH/CT/ปทุมธานี/ทม.ลำสามแก้ว,TH/CT/ปทุมธานี,66176,35491,30685,33373
1509,ทม.ล้อมแรด,TH/N_/52/ทม.ล้อมแรด,TH/N_/52,14287,7650,6637,7054
1510,ทม.วังน้ำเย็น,TH/E_/27/ทม.วังน้ำเย็น,TH/E_/27,20746,10662,10084,9717
1511,ทม.วังสะพุง,TH/NE/42/ทม.วังสะพุง,TH/NE/42,11027,5731,5296,4510
1512,ทม.วารินชำราบ,TH/NE/34/ทม.วารินชำราบ,TH/NE/34,26166,13832,12334,10885
1513,ทม.วิเชียรบุรี,TH/CT/67/ทม.วิเชียรบุรี,TH/CT/67,22379,11741,10638,8669
1514,ทม.ศรีราชา,TH/E_/ชลบุรี/ทม.ศรีราชา,TH/E_/ชลบุรี,23434,12910,10524,8520
1515,ทม.ศรีสะเกษ,TH/NE/33/ทม.ศรีสะเกษ,TH/NE/33,41032,21711,19321,20750
1516,ทม.ศรีสัชนาลัย,TH/CT/64/ทม.ศรีสัชนาลัย,TH/CT/64,15097,7913,7184,5772
1517,ทม.สตูล,TH/S_/91/ทม.สตูล,TH/S_/91,23144,11998,11146,10023
1518,ทม.สนั่นรักษ์,TH/CT/ปทุมธานี/ทม.สนั่นรักษ์,TH/CT/ปทุมธานี,31855,16826,15029,17377
1519,ทม.สมุทรสงคราม,TH/CT/75/ทม.สมุทรสงคราม,TH/CT/75,27323,14359,12964,10947
1520,ทม.สระบุรี,TH/CT/19/ทม.สระบุรี,TH/CT/19,59263,29782,29481,28569
1521,ทม.สระแก้ว,TH/E_/27/ทม.สระแก้ว,TH/E_/27,18363,9522,8841,11424
1522,ทม.สวรรคโลก,TH/CT/64/ทม.สวรรคโลก,TH/CT/64,15465,8142,7323,6724
1523,ทม.สองพี่น้อง,TH/CT/72/ทม.สองพี่น้อง,TH/CT/72,12346,6536,5810,5138
1524,ทม.สะเดา,TH/S_/90/ทม.สะเดา,TH/S_/90,21616,11090,10526,8747
1525,ทม.สะเตงนอก,TH/S_/95/ทม.สะเตงนอก,TH/S_/95,33914,17507,16407,14734
1526,ทม.สัตหีบ,TH/E_/ชลบุรี/ทม.สัตหีบ,TH/E_/ชลบุรี,22260,11626,10634,12080
1527,ทม.สามพราน,TH/CT/73/ทม.สามพราน,TH/CT/73,17038,8286,8752,8739
1528,ทม.สิงหนคร,TH/S_/90/ทม.สิงหนคร,TH/S_/90,39868,20162,19706,13077
1529,ทม.สิงห์บุรี,TH/CT/17/ทม.สิงห์บุรี,TH/CT/17,17079,9125,7954,9201
1530,ทม.สีคิ้ว,TH/NE/30/ทม.สีคิ้ว,TH/NE/30,16686,8818,7868,9365
1531,ทม.สุพรรณบุรี,TH/CT/72/ทม.สุพรรณบุรี,TH/CT/72,24890,13479,11411,12975
1532,ทม.สุรินทร์,TH/S_/32/ทม.สุรินทร์,TH/S_/32,38617,20895,17722,17172
1533,ทม.สุโขทัยธานี,TH/CT/64/ทม.สุโขทัยธานี,TH/CT/64,14045,7493,6552,7072
1534,ทม.สุไหงโกลก,TH/S_/96/ทม.สุไหงโกลก,TH/S_/96,40822,21510,19312,15395
1535,ทม.หนองคาย,TH/NE/43/ทม.หนองคาย,TH/NE/43,47111,24041,23070,24351
1536,ทม.หนองบัวลำภู,TH/NE/39/ทม.หนองบัวลำภู,TH/NE/39,21850,11351,10499,11941
1537,ทม.หนองปรือ,TH/E_/ชลบุรี/ทม.หนองปรือ,TH/E_/ชลบุรี,87054,48011,39043,50694
1538,ทม.หนองสำโรง,TH/NE/41/ทม.หนองสำโรง,TH/NE/41,28827,14822,14005,14844
1539,ทม.หลังสวน,TH/S_/86/ทม.หลังสวน,TH/S_/86,10986,5828,5158,6853
1540,ทม.หล่มสัก,TH/CT/67/ทม.หล่มสัก,TH/CT/67,11525,6053,5472,6538
1541,ทม.หัวหิน,TH/W_/ประจวบคีรีขันธ์/ทม.หัวหิน,TH/W_/ประจวบคีรีขันธ์,65033,33270,31763,57007
1542,ทม.อรัญญประเทศ,TH/E_/27/ทม.อรัญญประเทศ,TH/E_/27,16964,7913,9051,11256
1543,ทม.อรัญญิก,TH/CT/65/ทม.อรัญญิก,TH/CT/65,30414,13556,16858,14023
1544,ทม.อำนาจเจริญ,TH/NE/37/ทม.อำนาจเจริญ,TH/NE/37,24962,12970,11992,12695
1545,ทม.อุตรดิตถ์,TH/N_/53/ทม.อุตรดิตถ์,TH/N_/53,31218,16864,14354,14654
1546,ทม.อุทัยธานี,TH/CT/61/ทม.อุทัยธานี,TH/CT/61,14247,7684,6563,9614
1547,ทม.อโยธยา,TH/CT/14/ทม.อโยธยา,TH/CT/14,20101,10765,9336,10266
1548,ทม.อ่างทอง,TH/CT/15/ทม.อ่างทอง,TH/CT/15,12226,6409,5817,6597
1549,ทม.อ่างศิลา,TH/E_/ชลบุรี/ทม.อ่างศิลา,TH/E_/ชลบุรี,36365,19462,16903,21585
1550,ทม.เขลางค์นคร,TH/N_/52/ทม.เขลางค์นคร,TH/N_/52,59378,31207,28171,25687
1551,ทม.เขารูปช้าง,TH/S_/90/ทม.เขารูปช้าง,TH/S_/90,43108,22913,20195,20451
1552,ทม.เขาสามยอด,TH/CT/16/ทม.เขาสามยอด,TH/CT/16,29606,13301,16305,12324
1553,ทม.เดชอุดม,TH/NE/34/ทม.เดชอุดม,TH/NE/34,13394,6959,6435,6578
1554,ทม.เบตง,TH/S_/95/ทม.เบตง,TH/S_/95,26421,13691,12730,11310
1555,ทม.เพชรบุรี,TH/W_/76/ทม.เพชรบุรี,TH/W_/76,20976,11007,9969,10308
1556,ทม.เพชรบูรณ์,TH/CT/67/ทม.เพชรบูรณ์,TH/CT/67,20821,11107,9714,12662
1557,ทม.เมืองปัก,TH/NE/30/ทม.เมืองปัก,TH/NE/30,13640,7254,6386,6932
1558,ทม.เมืองพล,TH/NE/ขอนแก่น/ทม.เมืองพล,TH/NE/ขอนแก่น,10604,5557,5047,5403
1559,ทม.เมืองแกนพัฒนา,TH/N_/เชียงใหม่/ทม.เมืองแกนพัฒนา,TH/N_/เชียงใหม่,12879,6632,6247,5691
1560,ทม.เลย,TH/NE/42/ทม.เลย,TH/NE/42,20798,10448,10350,11715
1561,ทม.เสนา,TH/CT/14/ทม.เสนา,TH/CT/14,3714,1957,1757,1449
1562,ทม.แก่งคอย,TH/CT/19/ทม.แก่งคอย,TH/CT/19,11253,5815,5438,6152
1563,ทม.แพร่,TH/N_/54/ทม.แพร่,TH/N_/54,14881,8011,6870,8754
1564,ทม.แม่ฮ่องสอน,TH/N_/58/ทม.แม่ฮ่องสอน,TH/N_/58,7331,3720,3611,4646
1565,ทม.แม่เหียะ,TH/N_/เชียงใหม่/ทม.แม่เหียะ,TH/N_/เชียงใหม่,19655,10721,8934,13842
1566,ทม.แม่โจ้,TH/N_/เชียงใหม่/ทม.แม่โจ้,TH/N_/เชียงใหม่,23267,12576,10691,13995
1567,ทม.แสนสุข,TH/E_/ชลบุรี/ทม.แสนสุข,TH/E_/ชลบุรี,46131,24546,21585,37588
1568,ทม.โนนสูง-น้ำคำ,TH/NE/41/ทม.โนนสูง-น้ำคำ,TH/NE/41,8580,3976,4604,3542
1569,ทม.โพธาราม,TH/W_/70/ทม.โพธาราม,TH/W_/70,8746,4579,4167,3691
1570,ทม.ไทรม้า,TH/CT/12/ทม.ไทรม้า,TH/CT/12,23742,12792,10950,15710
1571,ทม.ไร่ขิง,TH/CT/73/ทม.ไร่ขิง,TH/CT/73,33549,17806,15743,24326
1572,ท้องถิ่นทต.นิคมสร้างตนเองลำโดมน้อย,TH/NE/34/ท้องถิ่นทต.นิคมสร้างตนเองลำโดมน้อย,TH/NE/34,7796,3892,3904,2865
1573,ท้องถิ่นเมืองพัทยา,TH/E_/ชลบุรี/ท้องถิ่นเมืองพัทยา,TH/E_/ชลบุรี,117606,63896,53710,170621
1574,อภ.กงหรา,TH/S_/93/อภ.กงหรา,TH/S_/93,29310,14622,14688,9369
1575,อภ.กงไกรลาศ,TH/CT/64/อภ.กงไกรลาศ,TH/CT/64,59493,30465,29028,20400
1576,อภ.กบินทร์บุรี,TH/E_/25/อภ.กบินทร์บุรี,TH/E_/25,135729,68945,66784,52464
1577,อภ.กมลาไสย,TH/NE/46/อภ.กมลาไสย,TH/NE/46,45779,23312,22467,12378
1578,อภ.กรงปินัง,TH/S_/95/อภ.กรงปินัง,TH/S_/95,29779,14780,14999,6530
1579,อภ.กระทุ่มแบน,TH/CT/74/อภ.กระทุ่มแบน,TH/CT/74,65274,33857,31417,38279
1580,อภ.กระนวน,TH/NE/ขอนแก่น/อภ.กระนวน,TH/NE/ขอนแก่น,68221,34286,33935,20068
1581,อภ.กระบุรี,TH/S_/85/อภ.กระบุรี,TH/S_/85,44712,21966,22746,22216
1582,อภ.กระสัง,TH/NE/31/อภ.กระสัง,TH/NE/31,101610,51370,50240,26184
1583,อภ.กระแสสินธุ์,TH/S_/90/อภ.กระแสสินธุ์,TH/S_/90,14968,7619,7349,5163
1584,อภ.กะทู้,TH/S_/83/อภ.กะทู้,TH/S_/83,7037,3678,3359,6688
1585,อภ.กะปง,TH/S_/82/อภ.กะปง,TH/S_/82,13344,6653,6691,5924
1586,อภ.กะพ้อ,TH/S_/94/อภ.กะพ้อ,TH/S_/94,18917,9591,9326,4444
1587,อภ.กะเปอร์,TH/S_/85/อภ.กะเปอร์,TH/S_/85,20421,10044,10377,7930
1588,อภ.กันตัง,TH/S_/92/อภ.กันตัง,TH/S_/92,75100,37660,37440,23967
1589,อภ.กันทรลักษ์,TH/NE/33/อภ.กันทรลักษ์,TH/NE/33,183705,91708,91997,51006
1590,อภ.กันทรวิชัย,TH/NE/44/อภ.กันทรวิชัย,TH/NE/44,55796,28331,27465,16208
1591,อภ.กันทรารมย์,TH/NE/33/อภ.กันทรารมย์,TH/NE/33,93523,46880,46643,24121
1592,อภ.กัลยาณิวัฒนา,TH/N_/เชียงใหม่/อภ.กัลยาณิวัฒนา,TH/N_/เชียงใหม่,12699,6147,6552,4250
1593,อภ.กาญจนดิษฐ์,TH/S_/84/อภ.กาญจนดิษฐ์,TH/S_/84,80206,40480,39726,32848
1594,อภ.กาบัง,TH/S_/95/อภ.กาบัง,TH/S_/95,25272,12341,12931,7053
1595,อภ.กาบเชิง,TH/S_/32/อภ.กาบเชิง,TH/S_/32,60037,29930,30107,18484
1596,อภ.กำแพงแสน,TH/CT/73/อภ.กำแพงแสน,TH/CT/73,120364,62145,58219,38863
1597,อภ.กุฉินารายณ์,TH/NE/46/อภ.กุฉินารายณ์,TH/NE/46,61851,30877,30974,20744
1598,อภ.กุดข้าวปุ้น,TH/NE/34/อภ.กุดข้าวปุ้น,TH/NE/34,36808,18408,18400,9457
1599,อภ.กุดจับ,TH/NE/41/อภ.กุดจับ,TH/NE/41,43753,21776,21977,13104
1600,อภ.กุดชุม,TH/NE/35/อภ.กุดชุม,TH/NE/35,61475,30479,30996,19532
1601,อภ.กุดบาก,TH/NE/47/อภ.กุดบาก,TH/NE/47,27813,13736,14077,8835
1602,อภ.กุดรัง,TH/NE/44/อภ.กุดรัง,TH/NE/44,37035,18388,18647,10579
1603,อภ.กุมภวาปี,TH/NE/41/อภ.กุมภวาปี,TH/NE/41,74436,37506,36930,21462
1604,อภ.กุยบุรี,TH/W_/ประจวบคีรีขันธ์/อภ.กุยบุรี,TH/W_/ประจวบคีรีขันธ์,34860,17683,17177,11142
1605,อภ.กุสุมาลย์,TH/NE/47/อภ.กุสุมาลย์,TH/NE/47,43552,21825,21727,13419
1606,อภ.กู่แก้ว,TH/NE/41/อภ.กู่แก้ว,TH/NE/41,22110,10987,11123,6778
1607,อภ.ขนอม,TH/S_/นครศรีธรรมราช/อภ.ขนอม,TH/S_/นครศรีธรรมราช,20414,10346,10068,9456
1608,อภ.ขลุง,TH/E_/22/อภ.ขลุง,TH/E_/22,25420,12883,12537,10040
1609,อภ.ขาณุวรลักษบุรี,TH/CT/62/อภ.ขาณุวรลักษบุรี,TH/CT/62,69112,34787,34325,25743
1610,อภ.ขามทะเลสอ,TH/NE/30/อภ.ขามทะเลสอ,TH/NE/30,25847,13191,12656,8360
1611,อภ.ขามสะแกแสง,TH/NE/30/อภ.ขามสะแกแสง,TH/NE/30,33340,16697,16643,9774
1612,อภ.ขุขันธ์,TH/NE/33/อภ.ขุขันธ์,TH/NE/33,145256,73014,72242,35222
1613,อภ.ขุนตาล,TH/N_/57/อภ.ขุนตาล,TH/N_/57,14083,7193,6890,5504
1614,อภ.ขุนยวม,TH/N_/58/อภ.ขุนยวม,TH/N_/58,20052,9719,10333,7622
1615,อภ.ขุนหาญ,TH/NE/33/อภ.ขุนหาญ,TH/NE/33,69073,34709,34364,18032
1616,อภ.คง,TH/NE/30/อภ.คง,TH/NE/30,74478,37734,36744,21133
1617,อภ.ครบุรี,TH/NE/30/อภ.ครบุรี,TH/NE/30,80442,40681,39761,30259
1618,อภ.คลองขลุง,TH/CT/62/อภ.คลองขลุง,TH/CT/62,56193,28633,27560,23406
1619,อภ.คลองท่อม,TH/S_/81/อภ.คลองท่อม,TH/S_/81,71499,35229,36270,24667
1620,อภ.คลองลาน,TH/CT/62/อภ.คลองลาน,TH/CT/62,39819,19537,20282,14910
1621,อภ.คลองหลวง,TH/CT/ปทุมธานี/อภ.คลองหลวง,TH/CT/ปทุมธานี,146860,77063,69797,68683
1622,อภ.คลองหอยโข่ง,TH/S_/90/อภ.คลองหอยโข่ง,TH/S_/90,12084,5805,6279,5073
1623,อภ.คลองหาด,TH/E_/27/อภ.คลองหาด,TH/E_/27,38885,19410,19475,13477
1624,อภ.คลองเขื่อน,TH/E_/24/อภ.คลองเขื่อน,TH/E_/24,12759,6537,6222,4399
1625,อภ.คลองใหญ่,TH/E_/23/อภ.คลองใหญ่,TH/E_/23,14686,7326,7360,5402
1626,อภ.ควนกาหลง,TH/S_/91/อภ.ควนกาหลง,TH/S_/91,35376,17622,17754,11917
1627,อภ.ควนขนุน,TH/S_/93/อภ.ควนขนุน,TH/S_/93,79199,41178,38021,29999
1628,อภ.ควนเนียง,TH/S_/90/อภ.ควนเนียง,TH/S_/90,30087,15332,14755,9769
1629,อภ.ควนโดน,TH/S_/91/อภ.ควนโดน,TH/S_/91,21615,10895,10720,5977
1630,อภ.คอนสวรรค์,TH/NE/36/อภ.คอนสวรรค์,TH/NE/36,48274,24336,23938,17836
1631,อภ.คอนสาร,TH/NE/36/อภ.คอนสาร,TH/NE/36,40933,20596,20337,13892
1632,อภ.คำชะอี,TH/NE/49/อภ.คำชะอี,TH/NE/49,44635,22341,22294,14350
1633,อภ.คำตากล้า,TH/NE/47/อภ.คำตากล้า,TH/NE/47,32803,16415,16388,11516
1634,อภ.คำม่วง,TH/NE/46/อภ.คำม่วง,TH/NE/46,26889,13415,13474,7348
1635,อภ.คำเขื่อนแก้ว,TH/NE/35/อภ.คำเขื่อนแก้ว,TH/NE/35,62012,30941,31071,19019
1636,อภ.คีรีมาศ,TH/CT/64/อภ.คีรีมาศ,TH/CT/64,46129,23340,22789,14276
1637,อภ.คีรีรัฐนิคม,TH/S_/84/อภ.คีรีรัฐนิคม,TH/S_/84,42194,21159,21035,16953
1638,อภ.คุระบุรี,TH/S_/82/อภ.คุระบุรี,TH/S_/82,24420,12117,12303,10176
1639,อภ.คูเมือง,TH/NE/31/อภ.คูเมือง,TH/NE/31,59271,29555,29716,16135
1640,อภ.ค่ายบางระจัน,TH/CT/17/อภ.ค่ายบางระจัน,TH/CT/17,25846,13403,12443,8821
1641,อภ.ค้อวัง,TH/NE/35/อภ.ค้อวัง,TH/NE/35,20716,10420,10296,5407
1642,อภ.ฆ้องชัย,TH/NE/46/อภ.ฆ้องชัย,TH/NE/46,26709,13497,13212,7449
1643,อภ.งาว,TH/N_/52/อภ.งาว,TH/N_/52,49135,24607,24528,17956
1644,อภ.จตุรพักตรพิมาน,TH/NE/45/อภ.จตุรพักตรพิมาน,TH/NE/45,51126,25731,25395,13753
1645,อภ.จอมทอง,TH/N_/เชียงใหม่/อภ.จอมทอง,TH/N_/เชียงใหม่,56976,28919,28057,19855
1646,อภ.จอมบึง,TH/W_/70/อภ.จอมบึง,TH/W_/70,57317,29009,28308,19183
1647,อภ.จอมพระ,TH/S_/32/อภ.จอมพระ,TH/S_/32,54684,27268,27416,13851
1648,อภ.จะนะ,TH/S_/90/อภ.จะนะ,TH/S_/90,101116,50914,50202,27516
1649,อภ.จะแนะ,TH/S_/96/อภ.จะแนะ,TH/S_/96,39286,19317,19969,9674
1650,อภ.จักราช,TH/NE/30/อภ.จักราช,TH/NE/30,67540,33853,33687,19156
1651,อภ.จังหาร,TH/NE/45/อภ.จังหาร,TH/NE/45,38427,19449,18978,12059
1652,อภ.จัตุรัส,TH/NE/36/อภ.จัตุรัส,TH/NE/36,68321,35138,33183,24667
1653,อภ.จุน,TH/N_/56/อภ.จุน,TH/N_/56,18391,9641,8750,7144
1654,อภ.จุฬาภรณ์,TH/S_/นครศรีธรรมราช/อภ.จุฬาภรณ์,TH/S_/นครศรีธรรมราช,31436,15952,15484,10679
1655,อภ.ฉวาง,TH/S_/นครศรีธรรมราช/อภ.ฉวาง,TH/S_/นครศรีธรรมราช,53531,27465,26066,19321
1656,อภ.ชนบท,TH/NE/ขอนแก่น/อภ.ชนบท,TH/NE/ขอนแก่น,39906,20279,19627,11520
1657,อภ.ชนแดน,TH/CT/67/อภ.ชนแดน,TH/CT/67,68232,34086,34146,27799
1658,อภ.ชะอวด,TH/S_/นครศรีธรรมราช/อภ.ชะอวด,TH/S_/นครศรีธรรมราช,82439,41547,40892,29715
1659,อภ.ชะอำ,TH/W_/76/อภ.ชะอำ,TH/W_/76,21961,11070,10891,8503
1660,อภ.ชัยบาดาล,TH/CT/16/อภ.ชัยบาดาล,TH/CT/16,73605,37182,36423,27833
1661,อภ.ชัยบุรี,TH/S_/84/อภ.ชัยบุรี,TH/S_/84,28177,13982,14195,11205
1662,อภ.ชาติตระการ,TH/CT/65/อภ.ชาติตระการ,TH/CT/65,35853,17708,18145,12257
1663,อภ.ชานุมาน,TH/NE/37/อภ.ชานุมาน,TH/NE/37,38649,19263,19386,11613
1664,อภ.ชำนิ,TH/NE/31/อภ.ชำนิ,TH/NE/31,35394,17714,17680,9058
1665,อภ.ชื่นชม,TH/NE/44/อภ.ชื่นชม,TH/NE/44,24604,12494,12110,6905
1666,อภ.ชุมตาบง,TH/CT/60/อภ.ชุมตาบง,TH/CT/60,18020,9078,8942,6400
1667,อภ.ชุมพลบุรี,TH/S_/32/อภ.ชุมพลบุรี,TH/S_/32,68841,34287,34554,18659
1668,อภ.ชุมพวง,TH/NE/30/อภ.ชุมพวง,TH/NE/30,73996,37152,36844,19968
1669,อภ.ชุมแพ,TH/NE/ขอนแก่น/อภ.ชุมแพ,TH/NE/ขอนแก่น,83752,41774,41978,25542
1670,อภ.ชุมแสง,TH/CT/60/อภ.ชุมแสง,TH/CT/60,53500,27552,25948,19299
1671,อภ.ช้างกลาง,TH/S_/นครศรีธรรมราช/อภ.ช้างกลาง,TH/S_/นครศรีธรรมราช,28432,14468,13964,10925
1672,อภ.ซับใหญ่,TH/NE/36/อภ.ซับใหญ่,TH/NE/36,15535,7649,7886,5631
1673,อภ.ซำสูง,TH/NE/ขอนแก่น/อภ.ซำสูง,TH/NE/ขอนแก่น,18229,9233,8996,5226
1674,อภ.ดงหลวง,TH/NE/49/อภ.ดงหลวง,TH/NE/49,38930,19327,19603,12102
1675,อภ.ดงเจริญ,TH/CT/66/อภ.ดงเจริญ,TH/CT/66,17370,8838,8532,6239
1676,อภ.ดอกคำใต้,TH/N_/56/อภ.ดอกคำใต้,TH/N_/56,38368,19679,18689,14720
1677,อภ.ดอนจาน,TH/NE/46/อภ.ดอนจาน,TH/NE/46,26085,13090,12995,7550
1678,อภ.ดอนตาล,TH/NE/49/อภ.ดอนตาล,TH/NE/49,38776,19297,19479,11507
1679,อภ.ดอนตูม,TH/CT/73/อภ.ดอนตูม,TH/CT/73,35087,17902,17185,10927
1680,อภ.ดอนพุด,TH/CT/19/อภ.ดอนพุด,TH/CT/19,1992,1025,967,658
1681,อภ.ดอนมดแดง,TH/NE/34/อภ.ดอนมดแดง,TH/NE/34,27247,13530,13717,7897
1682,อภ.ดอนสัก,TH/S_/84/อภ.ดอนสัก,TH/S_/84,24899,12476,12423,10377
1683,อภ.ดอนเจดีย์,TH/CT/72/อภ.ดอนเจดีย์,TH/CT/72,40434,20840,19594,14412
1684,อภ.ดอยสะเก็ด,TH/N_/เชียงใหม่/อภ.ดอยสะเก็ด,TH/N_/เชียงใหม่,46370,24119,22251,21860
1685,อภ.ดอยหลวง,TH/N_/57/อภ.ดอยหลวง,TH/N_/57,18708,9326,9382,8615
1686,อภ.ดอยหล่อ,TH/N_/เชียงใหม่/อภ.ดอยหล่อ,TH/N_/เชียงใหม่,25160,12931,12229,11522
1687,อภ.ดอยเต่า,TH/N_/เชียงใหม่/อภ.ดอยเต่า,TH/N_/เชียงใหม่,22986,11484,11502,8684
1688,อภ.ดำเนินสะดวก,TH/W_/70/อภ.ดำเนินสะดวก,TH/W_/70,73670,38049,35621,23203
1689,อภ.ด่านขุนทด,TH/NE/30/อภ.ด่านขุนทด,TH/NE/30,109546,55422,54124,34385
1690,อภ.ด่านช้าง,TH/CT/72/อภ.ด่านช้าง,TH/CT/72,61523,31108,30415,23590
1691,อภ.ด่านซ้าย,TH/NE/42/อภ.ด่านซ้าย,TH/NE/42,47962,23616,24346,15892
1692,อภ.ด่านมะขามเตี้ย,TH/W_/71/อภ.ด่านมะขามเตี้ย,TH/W_/71,31196,15559,15637,10941
1693,อภ.ตรอน,TH/N_/53/อภ.ตรอน,TH/N_/53,29874,15382,14492,10153
1694,อภ.ตระการพืชผล,TH/NE/34/อภ.ตระการพืชผล,TH/NE/34,112736,56087,56649,29495
1695,อภ.ตะกั่วทุ่ง,TH/S_/82/อภ.ตะกั่วทุ่ง,TH/S_/82,39485,19657,19828,15802
1696,อภ.ตะกั่วป่า,TH/S_/82/อภ.ตะกั่วป่า,TH/S_/82,41907,21136,20771,23677
1697,อภ.ตะพานหิน,TH/CT/66/อภ.ตะพานหิน,TH/CT/66,45280,23172,22108,15874
1698,อภ.ตะโหมด,TH/S_/93/อภ.ตะโหมด,TH/S_/93,14284,7216,7068,4681
1699,อภ.ตากฟ้า,TH/CT/60/อภ.ตากฟ้า,TH/CT/60,34185,17393,16792,12604
1700,อภ.ตากใบ,TH/S_/96/อภ.ตากใบ,TH/S_/96,54103,27412,26691,11914
1701,อภ.ตาคลี,TH/CT/60/อภ.ตาคลี,TH/CT/60,77925,39354,38571,29788
1702,อภ.ตาพระยา,TH/E_/27/อภ.ตาพระยา,TH/E_/27,54585,27226,27359,16009
1703,อภ.ตาลสุม,TH/NE/34/อภ.ตาลสุม,TH/NE/34,29872,14720,15152,8232
1704,อภ.ถลาง,TH/S_/83/อภ.ถลาง,TH/S_/83,91926,47243,44683,69914
1705,อภ.ถ้ำพรรณรา,TH/S_/นครศรีธรรมราช/อภ.ถ้ำพรรณรา,TH/S_/นครศรีธรรมราช,19303,9668,9635,7396
1706,อภ.ทรายทองวัฒนา,TH/CT/62/อภ.ทรายทองวัฒนา,TH/CT/62,13951,6954,6997,4160
1707,อภ.ทรายมูล,TH/NE/35/อภ.ทรายมูล,TH/NE/35,24625,12296,12329,7810
1708,อภ.ทองผาภูมิ,TH/W_/71/อภ.ทองผาภูมิ,TH/W_/71,66250,31815,34435,27539
1709,อภ.ทองแสนขัน,TH/N_/53/อภ.ทองแสนขัน,TH/N_/53,26779,13504,13275,9424
1710,อภ.ทับคล้อ,TH/CT/66/อภ.ทับคล้อ,TH/CT/66,33865,17232,16633,12531
1711,อภ.ทับปุด,TH/S_/82/อภ.ทับปุด,TH/S_/82,25090,12537,12553,8055
1712,อภ.ทับสะแก,TH/W_/ประจวบคีรีขันธ์/อภ.ทับสะแก,TH/W_/ประจวบคีรีขันธ์,43131,21835,21296,14838
1713,อภ.ทัพทัน,TH/CT/61/อภ.ทัพทัน,TH/CT/61,15963,8167,7796,5393
1714,อภ.ทุ่งช้าง,TH/N_/55/อภ.ทุ่งช้าง,TH/N_/55,15597,7740,7857,5190
1715,อภ.ทุ่งตะโก,TH/S_/86/อภ.ทุ่งตะโก,TH/S_/86,21424,10696,10728,9561
1716,อภ.ทุ่งฝน,TH/NE/41/อภ.ทุ่งฝน,TH/NE/41,25054,12368,12686,7163
1717,อภ.ทุ่งยางแดง,TH/S_/94/อภ.ทุ่งยางแดง,TH/S_/94,24966,12682,12284,5854
1718,อภ.ทุ่งศรีอุดม,TH/NE/34/อภ.ทุ่งศรีอุดม,TH/NE/34,29202,14428,14774,8957
1719,อภ.ทุ่งสง,TH/S_/นครศรีธรรมราช/อภ.ทุ่งสง,TH/S_/นครศรีธรรมราช,117230,57518,59712,47358
1720,อภ.ทุ่งหว้า,TH/S_/91/อภ.ทุ่งหว้า,TH/S_/91,21108,10514,10594,6649
1721,อภ.ทุ่งหัวช้าง,TH/N_/51/อภ.ทุ่งหัวช้าง,TH/N_/51,17635,8793,8842,6428
1722,อภ.ทุ่งเขาหลวง,TH/NE/45/อภ.ทุ่งเขาหลวง,TH/NE/45,23268,11744,11524,6372
1723,อภ.ทุ่งเสลี่ยม,TH/CT/64/อภ.ทุ่งเสลี่ยม,TH/CT/64,41853,21163,20690,14656
1724,อภ.ทุ่งใหญ่,TH/S_/นครศรีธรรมราช/อภ.ทุ่งใหญ่,TH/S_/นครศรีธรรมราช,69574,34936,34638,24071
1725,อภ.ท่าคันโท,TH/NE/46/อภ.ท่าคันโท,TH/NE/46,28891,14463,14428,8141
1726,อภ.ท่าฉาง,TH/S_/84/อภ.ท่าฉาง,TH/S_/84,29229,14513,14716,12914
1727,อภ.ท่าชนะ,TH/S_/84/อภ.ท่าชนะ,TH/S_/84,51755,25790,25965,22480
1728,อภ.ท่าช้าง,TH/CT/17/อภ.ท่าช้าง,TH/CT/17,5461,2894,2567,1840
1729,อภ.ท่าตะเกียบ,TH/E_/24/อภ.ท่าตะเกียบ,TH/E_/24,46824,23199,23625,17009
1730,อภ.ท่าตะโก,TH/CT/60/อภ.ท่าตะโก,TH/CT/60,60520,30915,29605,23482
1731,อภ.ท่าตูม,TH/S_/32/อภ.ท่าตูม,TH/S_/32,91795,45774,46021,23399
1732,อภ.ท่าบ่อ,TH/NE/43/อภ.ท่าบ่อ,TH/NE/43,61209,30967,30242,18399
1733,อภ.ท่าปลา,TH/N_/53/อภ.ท่าปลา,TH/N_/53,29005,14576,14429,10161
1734,อภ.ท่ามะกา,TH/W_/71/อภ.ท่ามะกา,TH/W_/71,90147,46422,43725,30600
1735,อภ.ท่าม่วง,TH/W_/71/อภ.ท่าม่วง,TH/W_/71,57747,29739,28008,23611
1736,อภ.ท่ายาง,TH/W_/76/อภ.ท่ายาง,TH/W_/76,48804,25034,23770,19740
1737,อภ.ท่าลี่,TH/NE/42/อภ.ท่าลี่,TH/NE/42,26106,13062,13044,9926
1738,อภ.ท่าวังผา,TH/N_/55/อภ.ท่าวังผา,TH/N_/55,45359,22657,22702,14490
1739,อภ.ท่าวุ้ง,TH/CT/16/อภ.ท่าวุ้ง,TH/CT/16,44150,22906,21244,15308
1740,อภ.ท่าศาลา,TH/S_/นครศรีธรรมราช/อภ.ท่าศาลา,TH/S_/นครศรีธรรมราช,115198,59385,55813,35793
1741,อภ.ท่าสองยาง,TH/W_/63/อภ.ท่าสองยาง,TH/W_/63,90670,44035,46635,23858
1742,อภ.ท่าหลวง,TH/CT/16/อภ.ท่าหลวง,TH/CT/16,25785,13027,12758,9324
1743,อภ.ท่าอุเทน,TH/NE/48/อภ.ท่าอุเทน,TH/NE/48,54764,27229,27535,15669
1744,อภ.ท่าเรือ,TH/CT/14/อภ.ท่าเรือ,TH/CT/14,31186,16307,14879,11162
1745,อภ.ท่าแซะ,TH/S_/86/อภ.ท่าแซะ,TH/S_/86,82407,41280,41127,35258
1746,อภ.ท่าแพ,TH/S_/91/อภ.ท่าแพ,TH/S_/91,29654,14951,14703,8716
1747,อภ.ท่าใหม่,TH/E_/22/อภ.ท่าใหม่,TH/E_/22,47794,24439,23355,17881
1748,อภ.ท้ายเหมือง,TH/S_/82/อภ.ท้ายเหมือง,TH/S_/82,45302,22386,22916,20768
1749,อภ.ธวัชบุรี,TH/NE/45/อภ.ธวัชบุรี,TH/NE/45,37607,18761,18846,11211
1750,อภ.ธาตุพนม,TH/NE/48/อภ.ธาตุพนม,TH/NE/48,72285,36373,35912,21867
1751,อภ.ธารโต,TH/S_/95/อภ.ธารโต,TH/S_/95,24072,11504,12568,9015
1752,อภ.นครชัยศรี,TH/CT/73/อภ.นครชัยศรี,TH/CT/73,101380,53175,48205,39072
1753,อภ.นครหลวง,TH/CT/14/อภ.นครหลวง,TH/CT/14,21943,11469,10474,11363
1754,อภ.นครไทย,TH/CT/65/อภ.นครไทย,TH/CT/65,67197,33738,33459,23603
1755,อภ.นบพิตำ,TH/S_/นครศรีธรรมราช/อภ.นบพิตำ,TH/S_/นครศรีธรรมราช,33561,16757,16804,11983
1756,อภ.นากลาง,TH/NE/39/อภ.นากลาง,TH/NE/39,66889,33247,33642,18437
1757,อภ.นาคู,TH/NE/46/อภ.นาคู,TH/NE/46,25804,12915,12889,8096
1758,อภ.นางรอง,TH/NE/31/อภ.นางรอง,TH/NE/31,93130,47231,45899,26187
1759,อภ.นาจะหลวย,TH/NE/34/อภ.นาจะหลวย,TH/NE/34,51421,25392,26029,17704
1760,อภ.นาดี,TH/E_/25/อภ.นาดี,TH/E_/25,43825,22021,21804,17467
1761,อภ.นาดูน,TH/NE/44/อภ.นาดูน,TH/NE/44,32656,16349,16307,8589
1762,อภ.นาด้วง,TH/NE/42/อภ.นาด้วง,TH/NE/42,9794,4859,4935,3584
1763,อภ.นาตาล,TH/NE/34/อภ.นาตาล,TH/NE/34,38418,19180,19238,11183
1764,อภ.นาทม,TH/NE/48/อภ.นาทม,TH/NE/48,23617,11738,11879,7390
1765,อภ.นาทวี,TH/S_/90/อภ.นาทวี,TH/S_/90,63040,31112,31928,19417
1766,อภ.นาน้อย,TH/N_/55/อภ.นาน้อย,TH/N_/55,29913,14904,15009,10327
1767,อภ.นาบอน,TH/S_/นครศรีธรรมราช/อภ.นาบอน,TH/S_/นครศรีธรรมราช,24210,12263,11947,8497
1768,อภ.นามน,TH/NE/46/อภ.นามน,TH/NE/46,29456,14807,14649,9305
1769,อภ.นายายอาม,TH/E_/22/อภ.นายายอาม,TH/E_/22,30796,15879,14917,11891
1770,อภ.นายูง,TH/NE/41/อภ.นายูง,TH/NE/41,28656,14174,14482,9643
1771,อภ.นาวัง,TH/NE/39/อภ.นาวัง,TH/NE/39,30472,15226,15246,8631
1772,อภ.นาหมื่น,TH/N_/55/อภ.นาหมื่น,TH/N_/55,14338,7075,7263,4481
1773,อภ.นาหม่อม,TH/S_/90/อภ.นาหม่อม,TH/S_/90,22933,11857,11076,8987
1774,อภ.นาหว้า,TH/NE/48/อภ.นาหว้า,TH/NE/48,39885,19950,19935,12958
1775,อภ.นาเชือก,TH/NE/44/อภ.นาเชือก,TH/NE/44,57160,28620,28540,17121
1776,อภ.นาเยีย,TH/NE/34/อภ.นาเยีย,TH/NE/34,20897,10090,10807,7056
1777,อภ.นาแก,TH/NE/48/อภ.นาแก,TH/NE/48,72352,36418,35934,21390
1778,อภ.นาแห้ว,TH/NE/42/อภ.นาแห้ว,TH/NE/42,9660,4812,4848,3057
1779,อภ.นาโพธิ์,TH/NE/31/อภ.นาโพธิ์,TH/NE/31,28620,14467,14153,7900
1780,อภ.นาโยง,TH/S_/92/อภ.นาโยง,TH/S_/92,41129,21191,19938,13405
1781,อภ.นิคมคำสร้อย,TH/NE/49/อภ.นิคมคำสร้อย,TH/NE/49,34079,17026,17053,10013
1782,อภ.นิคมน้ำอูน,TH/NE/47/อภ.นิคมน้ำอูน,TH/NE/47,14880,7432,7448,4578
1783,อภ.นิคมพัฒนา,TH/E_/21/อภ.นิคมพัฒนา,TH/E_/21,20322,10246,10076,15638
1784,อภ.น้ำขุ่น,TH/NE/34/อภ.น้ำขุ่น,TH/NE/34,33273,16461,16812,10832
1785,อภ.น้ำปาด,TH/N_/53/อภ.น้ำปาด,TH/N_/53,33309,16626,16683,11934
1786,อภ.น้ำพอง,TH/NE/ขอนแก่น/อภ.น้ำพอง,TH/NE/ขอนแก่น,73609,37026,36583,21950
1787,อภ.น้ำยืน,TH/NE/34/อภ.น้ำยืน,TH/NE/34,61219,30185,31034,20534
1788,อภ.น้ำหนาว,TH/CT/67/อภ.น้ำหนาว,TH/CT/67,18580,9045,9535,7071
1789,อภ.น้ำเกลี้ยง,TH/NE/33/อภ.น้ำเกลี้ยง,TH/NE/33,44329,21888,22441,11191
1790,อภ.น้ำโสม,TH/NE/41/อภ.น้ำโสม,TH/NE/41,41200,20335,20865,13191
1791,อภ.บรบือ,TH/NE/44/อภ.บรบือ,TH/NE/44,101593,50868,50725,34018
1792,อภ.บรรพตพิสัย,TH/CT/60/อภ.บรรพตพิสัย,TH/CT/60,81513,41624,39889,28538
1793,อภ.บันนังสตา,TH/S_/95/อภ.บันนังสตา,TH/S_/95,55921,27413,28508,15689
1794,อภ.บัวลาย,TH/NE/30/อภ.บัวลาย,TH/NE/30,21568,10826,10742,6354
1795,อภ.บัวเชด,TH/S_/32/อภ.บัวเชด,TH/S_/32,34940,17143,17797,9695
1796,อภ.บัวใหญ่,TH/NE/30/อภ.บัวใหญ่,TH/NE/30,67660,33784,33876,18938
1797,อภ.บางกรวย,TH/CT/12/อภ.บางกรวย,TH/CT/12,33647,18175,15472,19019
1798,อภ.บางกระทุ่ม,TH/CT/65/อภ.บางกระทุ่ม,TH/CT/65,32727,16809,15918,11545
1799,อภ.บางกล่ำ,TH/S_/90/อภ.บางกล่ำ,TH/S_/90,9966,5046,4920,3394
1800,อภ.บางขัน,TH/S_/นครศรีธรรมราช/อภ.บางขัน,TH/S_/นครศรีธรรมราช,47315,23431,23884,16553
1801,อภ.บางคนที,TH/CT/75/อภ.บางคนที,TH/CT/75,27385,14344,13041,9863
1802,อภ.บางคล้า,TH/E_/24/อภ.บางคล้า,TH/E_/24,30563,15735,14828,12527
1803,อภ.บางซ้าย,TH/CT/14/อภ.บางซ้าย,TH/CT/14,13969,7050,6919,4455
1804,อภ.บางน้ำเปรี้ยว,TH/E_/24/อภ.บางน้ำเปรี้ยว,TH/E_/24,72819,36647,36172,21667
1805,อภ.บางบัวทอง,TH/CT/12/อภ.บางบัวทอง,TH/CT/12,186383,99366,87017,96585
1806,อภ.บางบาล,TH/CT/14/อภ.บางบาล,TH/CT/14,14448,7510,6938,5433
1807,อภ.บางบ่อ,TH/CT/11/อภ.บางบ่อ,TH/CT/11,92548,47569,44979,45054
1808,อภ.บางปลาม้า,TH/CT/72/อภ.บางปลาม้า,TH/CT/72,59093,30311,28782,19645
1809,อภ.บางปะกง,TH/E_/24/อภ.บางปะกง,TH/E_/24,56157,28576,27581,26333
1810,อภ.บางปะหัน,TH/CT/14/อภ.บางปะหัน,TH/CT/14,36433,18857,17576,12530
1811,อภ.บางปะอิน,TH/CT/14/อภ.บางปะอิน,TH/CT/14,51069,26718,24351,26825
1812,อภ.บางพลี,TH/CT/11/อภ.บางพลี,TH/CT/11,262926,139290,123636,165989
1813,อภ.บางมูลนาก,TH/CT/66/อภ.บางมูลนาก,TH/CT/66,20594,10624,9970,7873
1814,อภ.บางระกำ,TH/CT/65/อภ.บางระกำ,TH/CT/65,74490,37872,36618,25986
1815,อภ.บางระจัน,TH/CT/17/อภ.บางระจัน,TH/CT/17,19444,10032,9412,7070
1816,อภ.บางละมุง,TH/E_/ชลบุรี/อภ.บางละมุง,TH/E_/ชลบุรี,28504,15075,13429,18127
1817,อภ.บางสะพาน,TH/W_/ประจวบคีรีขันธ์/อภ.บางสะพาน,TH/W_/ประจวบคีรีขันธ์,61487,30985,30502,26329
1818,อภ.บางสะพานน้อย,TH/W_/ประจวบคีรีขันธ์/อภ.บางสะพานน้อย,TH/W_/ประจวบคีรีขันธ์,36691,18356,18335,16029
1819,อภ.บางเลน,TH/CT/73/อภ.บางเลน,TH/CT/73,79553,40257,39296,28677
1820,อภ.บางเสาธง,TH/CT/11/อภ.บางเสาธง,TH/CT/11,59043,30461,28582,43802
1821,อภ.บางแก้ว,TH/S_/93/อภ.บางแก้ว,TH/S_/93,17843,8990,8853,6387
1822,อภ.บางแพ,TH/W_/70/อภ.บางแพ,TH/W_/70,17911,9327,8584,6532
1823,อภ.บางใหญ่,TH/CT/12/อภ.บางใหญ่,TH/CT/12,102512,55017,47495,51485
1824,อภ.บางไทร,TH/CT/14/อภ.บางไทร,TH/CT/14,31781,16290,15491,10554
1825,อภ.บาเจาะ,TH/S_/96/อภ.บาเจาะ,TH/S_/96,41132,20868,20264,9376
1826,อภ.บำเหน็จณรงค์,TH/NE/36/อภ.บำเหน็จณรงค์,TH/NE/36,40702,20574,20128,13399
1827,อภ.บึงนาราง,TH/CT/66/อภ.บึงนาราง,TH/CT/66,28766,14642,14124,10745
1828,อภ.บึงบูรพ์,TH/NE/33/อภ.บึงบูรพ์,TH/NE/33,4377,2191,2186,1080
1829,อภ.บึงสามพัน,TH/CT/67/อภ.บึงสามพัน,TH/CT/67,62873,31725,31148,25452
1830,อภ.บึงสามัคคี,TH/CT/62/อภ.บึงสามัคคี,TH/CT/62,18321,9188,9133,7245
1831,อภ.บึงโขงหลง,TH/NE/38/อภ.บึงโขงหลง,TH/NE/38,27894,13851,14043,8821
1832,อภ.บุณฑริก,TH/NE/34/อภ.บุณฑริก,TH/NE/34,77717,38304,39413,24339
1833,อภ.บุ่งคล้า,TH/NE/38/อภ.บุ่งคล้า,TH/NE/38,14012,7011,7001,4176
1834,อภ.บ่อทอง,TH/E_/ชลบุรี/อภ.บ่อทอง,TH/E_/ชลบุรี,37669,18691,18978,13367
1835,อภ.บ่อพลอย,TH/W_/71/อภ.บ่อพลอย,TH/W_/71,48214,24150,24064,18508
1836,อภ.บ่อเกลือ,TH/N_/55/อภ.บ่อเกลือ,TH/N_/55,15238,7448,7790,4903
1837,อภ.บ่อไร่,TH/E_/23/อภ.บ่อไร่,TH/E_/23,18688,8991,9697,7576
1838,อภ.บ้านกรวด,TH/NE/31/อภ.บ้านกรวด,TH/NE/31,41191,20658,20533,11296
1839,อภ.บ้านคา,TH/W_/70/อภ.บ้านคา,TH/W_/70,25286,12343,12943,9586
1840,อภ.บ้านค่าย,TH/E_/21/อภ.บ้านค่าย,TH/E_/21,66213,33887,32326,33972
1841,อภ.บ้านฉาง,TH/E_/21/อภ.บ้านฉาง,TH/E_/21,10549,4977,5572,4621
1842,อภ.บ้านดุง,TH/NE/41/อภ.บ้านดุง,TH/NE/41,111576,55624,55952,32445
1843,อภ.บ้านด่าน,TH/NE/31/อภ.บ้านด่าน,TH/NE/31,18827,9536,9291,4555
1844,อภ.บ้านด่านลานหอย,TH/CT/64/อภ.บ้านด่านลานหอย,TH/CT/64,44318,22131,22187,14312
1845,อภ.บ้านตาก,TH/W_/63/อภ.บ้านตาก,TH/W_/63,31387,15818,15569,10829
1846,อภ.บ้านตาขุน,TH/S_/84/อภ.บ้านตาขุน,TH/S_/84,9148,4591,4557,3888
1847,อภ.บ้านธิ,TH/N_/51/อภ.บ้านธิ,TH/N_/51,8075,4212,3863,3355
1848,อภ.บ้านนา,TH/CT/26/อภ.บ้านนา,TH/CT/26,64511,32244,32267,23901
1849,อภ.บ้านนาสาร,TH/S_/84/อภ.บ้านนาสาร,TH/S_/84,51031,25857,25174,18180
1850,อภ.บ้านนาเดิม,TH/S_/84/อภ.บ้านนาเดิม,TH/S_/84,20820,10515,10305,7681
1851,อภ.บ้านบึง,TH/E_/ชลบุรี/อภ.บ้านบึง,TH/E_/ชลบุรี,82404,41793,40611,44781
1852,อภ.บ้านผือ,TH/NE/41/อภ.บ้านผือ,TH/NE/41,102210,51062,51148,30683
1853,อภ.บ้านฝาง,TH/NE/ขอนแก่น/อภ.บ้านฝาง,TH/NE/ขอนแก่น,50384,25297,25087,16942
1854,อภ.บ้านม่วง,TH/NE/47/อภ.บ้านม่วง,TH/NE/47,67334,33351,33983,19669
1855,อภ.บ้านลาด,TH/W_/76/อภ.บ้านลาด,TH/W_/76,48270,25184,23086,15724
1856,อภ.บ้านสร้าง,TH/E_/25/อภ.บ้านสร้าง,TH/E_/25,27748,14132,13616,9598
1857,อภ.บ้านหมอ,TH/CT/19/อภ.บ้านหมอ,TH/CT/19,31556,16221,15335,12275
1858,อภ.บ้านหมี่,TH/CT/16/อภ.บ้านหมี่,TH/CT/16,69719,36195,33524,25041
1859,อภ.บ้านหลวง,TH/N_/55/อภ.บ้านหลวง,TH/N_/55,11542,5757,5785,3949
1860,อภ.บ้านเขว้า,TH/NE/36/อภ.บ้านเขว้า,TH/NE/36,42270,21365,20905,14558
1861,อภ.บ้านเหลื่อม,TH/NE/30/อภ.บ้านเหลื่อม,TH/NE/30,17260,8691,8569,5060
1862,อภ.บ้านแท่น,TH/NE/36/อภ.บ้านแท่น,TH/NE/36,41109,20716,20393,11591
1863,อภ.บ้านแพง,TH/NE/48/อภ.บ้านแพง,TH/NE/48,26521,13122,13399,7999
1864,อภ.บ้านแพรก,TH/CT/14/อภ.บ้านแพรก,TH/CT/14,6851,3662,3189,2665
1865,อภ.บ้านแพ้ว,TH/CT/74/อภ.บ้านแพ้ว,TH/CT/74,50056,26075,23981,15560
1866,อภ.บ้านแหลม,TH/W_/76/อภ.บ้านแหลม,TH/W_/76,36316,18540,17776,11465
1867,อภ.บ้านแฮด,TH/NE/ขอนแก่น/อภ.บ้านแฮด,TH/NE/ขอนแก่น,26081,13169,12912,8231
1868,อภ.บ้านโคก,TH/N_/53/อภ.บ้านโคก,TH/N_/53,10503,5173,5330,4457
1869,อภ.บ้านโป่ง,TH/W_/70/อภ.บ้านโป่ง,TH/W_/70,97074,50562,46512,36712
1870,อภ.บ้านโพธิ์,TH/E_/24/อภ.บ้านโพธิ์,TH/E_/24,45838,23719,22119,20602
1871,อภ.บ้านโฮ่ง,TH/N_/51/อภ.บ้านโฮ่ง,TH/N_/51,26058,13350,12708,10201
1872,อภ.บ้านใหม่ไชยพจน์,TH/NE/31/อภ.บ้านใหม่ไชยพจน์,TH/NE/31,22233,11254,10979,6043
1873,อภ.บ้านไผ่,TH/NE/ขอนแก่น/อภ.บ้านไผ่,TH/NE/ขอนแก่น,72364,36436,35928,22582
1874,อภ.บ้านไร่,TH/CT/61/อภ.บ้านไร่,TH/CT/61,63480,31914,31566,24536
1875,อภ.ปง,TH/N_/56/อภ.ปง,TH/N_/56,39501,19670,19831,12375
1876,อภ.ปทุมรัตต์,TH/NE/45/อภ.ปทุมรัตต์,TH/NE/45,47245,23762,23483,12769
1877,อภ.ปทุมราชวงศา,TH/NE/37/อภ.ปทุมราชวงศา,TH/NE/37,45516,22579,22937,13382
1878,อภ.ประจักษ์ศิลปาคม,TH/NE/41/อภ.ประจักษ์ศิลปาคม,TH/NE/41,25572,12768,12804,7193
1879,อภ.ประจันตคาม,TH/E_/25/อภ.ประจันตคาม,TH/E_/25,49952,25618,24334,16945
1880,อภ.ประทาย,TH/NE/30/อภ.ประทาย,TH/NE/30,71439,35927,35512,19243
1881,อภ.ประโคนชัย,TH/NE/31/อภ.ประโคนชัย,TH/NE/31,125197,62784,62413,35969
1882,อภ.ปรางค์กู่,TH/NE/33/อภ.ปรางค์กู่,TH/NE/33,63553,31890,31663,15074
1883,อภ.ปราณบุรี,TH/W_/ประจวบคีรีขันธ์/อภ.ปราณบุรี,TH/W_/ประจวบคีรีขันธ์,53540,24790,28750,27075
1884,อภ.ปราสาท,TH/S_/32/อภ.ปราสาท,TH/S_/32,144250,72881,71369,41680
1885,อภ.ปลวกแดง,TH/E_/21/อภ.ปลวกแดง,TH/E_/21,69264,33947,35317,94541
1886,อภ.ปลาปาก,TH/NE/48/อภ.ปลาปาก,TH/NE/48,50465,25097,25368,16217
1887,อภ.ปลายพระยา,TH/S_/81/อภ.ปลายพระยา,TH/S_/81,32411,16185,16226,10959
1888,อภ.ปะคำ,TH/NE/31/อภ.ปะคำ,TH/NE/31,38457,19197,19260,11766
1889,อภ.ปะทิว,TH/S_/86/อภ.ปะทิว,TH/S_/86,40004,20205,19799,17906
1890,อภ.ปะนาเระ,TH/S_/94/อภ.ปะนาเระ,TH/S_/94,36634,18706,17928,9536
1891,อภ.ปะเหลียน,TH/S_/92/อภ.ปะเหลียน,TH/S_/92,62982,31899,31083,21459
1892,อภ.ปักธงชัย,TH/NE/30/อภ.ปักธงชัย,TH/NE/30,92568,47375,45193,32039
1893,อภ.ปัว,TH/N_/55/อภ.ปัว,TH/N_/55,53840,27062,26778,15914
1894,อภ.ปากคาด,TH/NE/38/อภ.ปากคาด,TH/NE/38,28097,14008,14089,9535
1895,อภ.ปากชม,TH/NE/42/อภ.ปากชม,TH/NE/42,33514,16437,17077,11152
1896,อภ.ปากช่อง,TH/NE/30/อภ.ปากช่อง,TH/NE/30,124419,62712,61707,66800
1897,อภ.ปากท่อ,TH/W_/70/อภ.ปากท่อ,TH/W_/70,51215,26154,25061,18512
1898,อภ.ปากพนัง,TH/S_/นครศรีธรรมราช/อภ.ปากพนัง,TH/S_/นครศรีธรรมราช,78257,38856,39401,25868
1899,อภ.ปากพลี,TH/CT/26/อภ.ปากพลี,TH/CT/26,22412,11554,10858,8471
1900,อภ.ปากพะยูน,TH/S_/93/อภ.ปากพะยูน,TH/S_/93,32824,16650,16174,11004
1901,อภ.ปากเกร็ด,TH/CT/12/อภ.ปากเกร็ด,TH/CT/12,49740,26245,23495,23589
1902,อภ.ปางมะผ้า,TH/N_/58/อภ.ปางมะผ้า,TH/N_/58,21703,10518,11185,8597
1903,อภ.ปางศิลาทอง,TH/CT/62/อภ.ปางศิลาทอง,TH/CT/62,30404,15223,15181,11049
1904,อภ.ปาย,TH/N_/58/อภ.ปาย,TH/N_/58,35050,16874,18176,14988
1905,อภ.ป่าซาง,TH/N_/51/อภ.ป่าซาง,TH/N_/51,28747,14835,13912,12815
1906,อภ.ป่าติ้ว,TH/NE/35/อภ.ป่าติ้ว,TH/NE/35,31975,16002,15973,9993
1907,อภ.ป่าบอน,TH/S_/93/อภ.ป่าบอน,TH/S_/93,43807,22094,21713,15726
1908,อภ.ป่าพะยอม,TH/S_/93/อภ.ป่าพะยอม,TH/S_/93,27218,13932,13286,10717
1909,อภ.ป่าแดด,TH/N_/57/อภ.ป่าแดด,TH/N_/57,11878,5985,5893,4044
1910,อภ.ป่าโมก,TH/CT/15/อภ.ป่าโมก,TH/CT/15,18896,9907,8989,6665
1911,อภ.ผักไห่,TH/CT/14/อภ.ผักไห่,TH/CT/14,22387,11565,10822,7271
1912,อภ.ผาขาว,TH/NE/42/อภ.ผาขาว,TH/NE/42,31096,15507,15589,8428
1913,อภ.ฝาง,TH/N_/เชียงใหม่/อภ.ฝาง,TH/N_/เชียงใหม่,112115,56609,55506,40555
1914,อภ.พญาเม็งราย,TH/N_/57/อภ.พญาเม็งราย,TH/N_/57,27415,13790,13625,9667
1915,อภ.พนม,TH/S_/84/อภ.พนม,TH/S_/84,24481,12004,12477,9370
1916,อภ.พนมดงรัก,TH/S_/32/อภ.พนมดงรัก,TH/S_/32,38009,18755,19254,12246
1917,อภ.พนมทวน,TH/W_/71/อภ.พนมทวน,TH/W_/71,32613,16714,15899,11130
1918,อภ.พนมสารคาม,TH/E_/24/อภ.พนมสารคาม,TH/E_/24,71049,36471,34578,29929
1919,อภ.พนมไพร,TH/NE/45/อภ.พนมไพร,TH/NE/45,60475,30314,30161,17566
1920,อภ.พนัสนิคม,TH/E_/ชลบุรี/อภ.พนัสนิคม,TH/E_/ชลบุรี,100938,51971,48967,36074
1921,อภ.พนา,TH/NE/37/อภ.พนา,TH/NE/37,19162,9503,9659,6545
1922,อภ.พบพระ,TH/W_/63/อภ.พบพระ,TH/W_/63,83057,40717,42340,20064
1923,อภ.พยัคฆภูมิพิสัย,TH/NE/44/อภ.พยัคฆภูมิพิสัย,TH/NE/44,79592,40009,39583,21667
1924,อภ.พยุหะคีรี,TH/CT/60/อภ.พยุหะคีรี,TH/CT/60,49997,25670,24327,21002
1925,อภ.พยุห์,TH/NE/33/อภ.พยุห์,TH/NE/33,31279,15809,15470,8184
1926,อภ.พรรณานิคม,TH/NE/47/อภ.พรรณานิคม,TH/NE/47,78001,39245,38756,26445
1927,อภ.พรหมคีรี,TH/S_/นครศรีธรรมราช/อภ.พรหมคีรี,TH/S_/นครศรีธรรมราช,27305,13856,13449,8957
1928,อภ.พรหมบุรี,TH/CT/17/อภ.พรหมบุรี,TH/CT/17,16654,8760,7894,5912
1929,อภ.พรหมพิราม,TH/CT/65/อภ.พรหมพิราม,TH/CT/65,81399,41696,39703,30550
1930,อภ.พระทองคำ,TH/NE/30/อภ.พระทองคำ,TH/NE/30,36648,18450,18198,12012
1931,อภ.พระนครศรีอยุธยา,TH/CT/14/อภ.พระนครศรีอยุธยา,TH/CT/14,70480,36800,33680,24750
1932,อภ.พระประแดง,TH/CT/11/อภ.พระประแดง,TH/CT/11,38804,20191,18613,13440
1933,อภ.พระพรหม,TH/S_/นครศรีธรรมราช/อภ.พระพรหม,TH/S_/นครศรีธรรมราช,44494,22559,21935,16285
1934,อภ.พระพุทธบาท,TH/CT/19/อภ.พระพุทธบาท,TH/CT/19,24441,12560,11881,9739
1935,อภ.พระยืน,TH/NE/ขอนแก่น/อภ.พระยืน,TH/NE/ขอนแก่น,24882,12710,12172,7547
1936,อภ.พระสมุทรเจดีย์,TH/CT/11/อภ.พระสมุทรเจดีย์,TH/CT/11,114609,59376,55233,53227
1937,อภ.พระแสง,TH/S_/84/อภ.พระแสง,TH/S_/84,62699,31206,31493,24170
1938,อภ.พรานกระต่าย,TH/CT/62/อภ.พรานกระต่าย,TH/CT/62,48732,24351,24381,16207
1939,อภ.พรเจริญ,TH/NE/38/อภ.พรเจริญ,TH/NE/38,28872,14337,14535,8037
1940,อภ.พร้าว,TH/N_/เชียงใหม่/อภ.พร้าว,TH/N_/เชียงใหม่,37307,18873,18434,15526
1941,อภ.พล,TH/NE/ขอนแก่น/อภ.พล,TH/NE/ขอนแก่น,75873,38320,37553,22503
1942,อภ.พลับพลาชัย,TH/NE/31/อภ.พลับพลาชัย,TH/NE/31,27782,13620,14162,7056
1943,อภ.พะโต๊ะ,TH/S_/86/อภ.พะโต๊ะ,TH/S_/86,23068,11279,11789,10702
1944,อภ.พังโคน,TH/NE/47/อภ.พังโคน,TH/NE/47,46111,23347,22764,17283
1945,อภ.พัฒนานิคม,TH/CT/16/อภ.พัฒนานิคม,TH/CT/16,54022,27387,26635,23220
1946,อภ.พาน,TH/N_/57/อภ.พาน,TH/N_/57,112755,57917,54838,47738
1947,อภ.พานทอง,TH/E_/ชลบุรี/อภ.พานทอง,TH/E_/ชลบุรี,46580,23667,22913,36276
1948,อภ.พิชัย,TH/N_/53/อภ.พิชัย,TH/N_/53,72004,37030,34974,25630
1949,อภ.พิบูลมังสาหาร,TH/NE/34/อภ.พิบูลมังสาหาร,TH/NE/34,104254,51696,52558,33966
1950,อภ.พิบูลย์รักษ์,TH/NE/41/อภ.พิบูลย์รักษ์,TH/NE/41,24645,12388,12257,8259
1951,อภ.พิปูน,TH/S_/นครศรีธรรมราช/อภ.พิปูน,TH/S_/นครศรีธรรมราช,18089,9186,8903,7274
1952,อภ.พิมาย,TH/NE/30/อภ.พิมาย,TH/NE/30,120406,61133,59273,38785
1953,อภ.พุทธมณฑล,TH/CT/73/อภ.พุทธมณฑล,TH/CT/73,21441,11603,9838,11612
1954,อภ.พุทไธสง,TH/NE/31/อภ.พุทไธสง,TH/NE/31,41760,21333,20427,12159
1955,อภ.พุนพิน,TH/S_/84/อภ.พุนพิน,TH/S_/84,74548,37235,37313,35363
1956,อภ.ฟากท่า,TH/N_/53/อภ.ฟากท่า,TH/N_/53,13425,6889,6536,5068
1957,อภ.ภักดีชุมพล,TH/NE/36/อภ.ภักดีชุมพล,TH/NE/36,30925,15270,15655,11996
1958,อภ.ภาชี,TH/CT/14/อภ.ภาชี,TH/CT/14,25670,13225,12445,8149
1959,อภ.ภูกระดึง,TH/NE/42/อภ.ภูกระดึง,TH/NE/42,27265,13517,13748,8669
1960,อภ.ภูกามยาว,TH/N_/56/อภ.ภูกามยาว,TH/N_/56,12723,6615,6108,4993
1961,อภ.ภูซาง,TH/N_/56/อภ.ภูซาง,TH/N_/56,24400,12290,12110,9425
1962,อภ.ภูผาม่าน,TH/NE/ขอนแก่น/อภ.ภูผาม่าน,TH/NE/ขอนแก่น,19669,9796,9873,5806
1963,อภ.ภูพาน,TH/NE/47/อภ.ภูพาน,TH/NE/47,35960,17809,18151,12338
1964,อภ.ภูสิงห์,TH/NE/33/อภ.ภูสิงห์,TH/NE/33,54666,27130,27536,15810
1965,อภ.ภูหลวง,TH/NE/42/อภ.ภูหลวง,TH/NE/42,25045,12382,12663,7690
1966,อภ.ภูเขียว,TH/NE/36/อภ.ภูเขียว,TH/NE/36,108791,55127,53664,35086
1967,อภ.ภูเพียง,TH/N_/55/อภ.ภูเพียง,TH/N_/55,36022,18166,17856,13548
1968,อภ.ภูเรือ,TH/NE/42/อภ.ภูเรือ,TH/NE/42,19729,9678,10051,7198
1969,อภ.ภูเวียง,TH/NE/ขอนแก่น/อภ.ภูเวียง,TH/NE/ขอนแก่น,68941,34652,34289,20205
1970,อภ.มวกเหล็ก,TH/CT/19/อภ.มวกเหล็ก,TH/CT/19,49477,24837,24640,21846
1971,อภ.มหาชนะชัย,TH/NE/35/อภ.มหาชนะชัย,TH/NE/35,51511,25742,25769,14271
1972,อภ.มหาราช,TH/CT/14/อภ.มหาราช,TH/CT/14,13424,7028,6396,5023
1973,อภ.มะขาม,TH/E_/22/อภ.มะขาม,TH/E_/22,30601,15474,15127,13275
1974,อภ.มะนัง,TH/S_/91/อภ.มะนัง,TH/S_/91,18509,9036,9473,6319
1975,อภ.มัญจาคีรี,TH/NE/ขอนแก่น/อภ.มัญจาคีรี,TH/NE/ขอนแก่น,66879,33679,33200,21379
1976,อภ.มายอ,TH/S_/94/อภ.มายอ,TH/S_/94,56109,28395,27714,12716
1977,อภ.มโนรมย์,TH/CT/18/อภ.มโนรมย์,TH/CT/18,23861,12440,11421,8792
1978,อภ.ม่วงสามสิบ,TH/NE/34/อภ.ม่วงสามสิบ,TH/NE/34,81581,40729,40852,22566
1979,อภ.ยะรัง,TH/S_/94/อภ.ยะรัง,TH/S_/94,89733,44930,44803,21773
1980,อภ.ยะหริ่ง,TH/S_/94/อภ.ยะหริ่ง,TH/S_/94,70178,35257,34921,15895
1981,อภ.ยะหา,TH/S_/95/อภ.ยะหา,TH/S_/95,61341,30563,30778,14407
1982,อภ.ยางชุมน้อย,TH/NE/33/อภ.ยางชุมน้อย,TH/NE/33,29704,14767,14937,7510
1983,อภ.ยางตลาด,TH/NE/46/อภ.ยางตลาด,TH/NE/46,81721,41523,40198,24056
1984,อภ.ยางสีสุราช,TH/NE/44/อภ.ยางสีสุราช,TH/NE/44,35143,17664,17479,9676
1985,อภ.ยี่งอ,TH/S_/96/อภ.ยี่งอ,TH/S_/96,44051,22319,21732,10454
1986,อภ.ย่านตาขาว,TH/S_/92/อภ.ย่านตาขาว,TH/S_/92,56664,28830,27834,17741
1987,อภ.ระแงะ,TH/S_/96/อภ.ระแงะ,TH/S_/96,78081,39706,38375,17399
1988,อภ.ระโนด,TH/S_/90/อภ.ระโนด,TH/S_/90,48572,24602,23970,19310
1989,อภ.รัตนบุรี,TH/S_/32/อภ.รัตนบุรี,TH/S_/32,86977,43599,43378,22625
1990,อภ.รัตนวาปี,TH/NE/43/อภ.รัตนวาปี,TH/NE/43,37990,18926,19064,12932
1991,อภ.รัตภูมิ,TH/S_/90/อภ.รัตภูมิ,TH/S_/90,67608,34025,33583,21813
1992,อภ.รัษฎา,TH/S_/92/อภ.รัษฎา,TH/S_/92,26996,13695,13301,9829
1993,อภ.ราชสาส์น,TH/E_/24/อภ.ราชสาส์น,TH/E_/24,12665,6460,6205,4692
1994,อภ.รามัน,TH/S_/95/อภ.รามัน,TH/S_/95,86489,43701,42788,20622
1995,อภ.ราษีไศล,TH/NE/33/อภ.ราษีไศล,TH/NE/33,75843,38018,37825,19997
1996,อภ.รือเสาะ,TH/S_/96/อภ.รือเสาะ,TH/S_/96,66466,33352,33114,15681
1997,อภ.ร่องคำ,TH/NE/46/อภ.ร่องคำ,TH/NE/46,10474,5291,5183,3251
1998,อภ.ร่อนพิบูลย์,TH/S_/นครศรีธรรมราช/อภ.ร่อนพิบูลย์,TH/S_/นครศรีธรรมราช,61491,30837,30654,20042
1999,อภ.ร้องกวาง,TH/N_/54/อภ.ร้องกวาง,TH/N_/54,35562,18430,17132,12559
2000,อภ.ลอง,TH/N_/54/อภ.ลอง,TH/N_/54,30670,15413,15257,11356
2001,อภ.ละงู,TH/S_/91/อภ.ละงู,TH/S_/91,68475,34388,34087,20869
2002,อภ.ละหานทราย,TH/NE/31/อภ.ละหานทราย,TH/NE/31,19470,9684,9786,5707
2003,อภ.ละอุ่น,TH/S_/85/อภ.ละอุ่น,TH/S_/85,12442,6116,6326,5510
2004,อภ.ละแม,TH/S_/86/อภ.ละแม,TH/S_/86,26400,13146,13254,11781
2005,อภ.ลับแล,TH/N_/53/อภ.ลับแล,TH/N_/53,36401,18369,18032,14967
2006,อภ.ลาดบัวหลวง,TH/CT/14/อภ.ลาดบัวหลวง,TH/CT/14,29721,15057,14664,9578
2007,อภ.ลาดยาว,TH/CT/60/อภ.ลาดยาว,TH/CT/60,73785,37609,36176,27641
2008,อภ.ลาดหลุมแก้ว,TH/CT/ปทุมธานี/อภ.ลาดหลุมแก้ว,TH/CT/ปทุมธานี,58885,30107,28778,29565
2009,อภ.ลานกระบือ,TH/CT/62/อภ.ลานกระบือ,TH/CT/62,32801,16435,16366,11122
2010,อภ.ลานสกา,TH/S_/นครศรีธรรมราช/อภ.ลานสกา,TH/S_/นครศรีธรรมราช,39306,20146,19160,14466
2011,อภ.ลานสัก,TH/CT/61/อภ.ลานสัก,TH/CT/61,55443,27847,27596,18767
2012,อภ.ลำดวน,TH/S_/32/อภ.ลำดวน,TH/S_/32,26818,13423,13395,7043
2013,อภ.ลำทะเมนชัย,TH/NE/30/อภ.ลำทะเมนชัย,TH/NE/30,28079,14108,13971,7481
2014,อภ.ลำทับ,TH/S_/81/อภ.ลำทับ,TH/S_/81,20288,10024,10264,7291
2015,อภ.ลำปลายมาศ,TH/NE/31/อภ.ลำปลายมาศ,TH/NE/31,114825,57473,57352,30838
2016,อภ.ลำลูกกา,TH/CT/ปทุมธานี/อภ.ลำลูกกา,TH/CT/ปทุมธานี,85321,44025,41296,41769
2017,อภ.ลำสนธิ,TH/CT/16/อภ.ลำสนธิ,TH/CT/16,27251,13671,13580,10329
2018,อภ.ลี้,TH/N_/51/อภ.ลี้,TH/N_/51,61654,30626,31028,21165
2019,อภ.ลืออำนาจ,TH/NE/37/อภ.ลืออำนาจ,TH/NE/37,34233,17253,16980,9604
2020,อภ.วชิรบารมี,TH/CT/66/อภ.วชิรบารมี,TH/CT/66,31045,15703,15342,10897
2021,อภ.วังจันทร์,TH/E_/21/อภ.วังจันทร์,TH/E_/21,22317,11250,11067,10978
2022,อภ.วังชิ้น,TH/N_/54/อภ.วังชิ้น,TH/N_/54,42617,21381,21236,15226
2023,อภ.วังทรายพูน,TH/CT/66/อภ.วังทรายพูน,TH/CT/66,17523,8841,8682,5842
2024,อภ.วังทอง,TH/CT/65/อภ.วังทอง,TH/CT/65,114436,57818,56618,43228
2025,อภ.วังน้อย,TH/CT/14/อภ.วังน้อย,TH/CT/14,55381,28382,26999,25227
2026,อภ.วังน้ำเขียว,TH/NE/30/อภ.วังน้ำเขียว,TH/NE/30,43349,21730,21619,19004
2027,อภ.วังน้ำเย็น,TH/E_/27/อภ.วังน้ำเย็น,TH/E_/27,40571,20215,20356,14995
2028,อภ.วังม่วง,TH/CT/19/อภ.วังม่วง,TH/CT/19,11601,5923,5678,4565
2029,อภ.วังยาง,TH/NE/48/อภ.วังยาง,TH/NE/48,15489,7693,7796,4682
2030,อภ.วังวิเศษ,TH/S_/92/อภ.วังวิเศษ,TH/S_/92,40449,20347,20102,13916
2031,อภ.วังสมบูรณ์,TH/E_/27/อภ.วังสมบูรณ์,TH/E_/27,25376,12655,12721,10312
2032,อภ.วังสะพุง,TH/NE/42/อภ.วังสะพุง,TH/NE/42,100317,50439,49878,33760
2033,อภ.วังสามหมอ,TH/NE/41/อภ.วังสามหมอ,TH/NE/41,31456,15606,15850,8641
2034,อภ.วังหิน,TH/NE/33/อภ.วังหิน,TH/NE/33,40068,19857,20211,9432
2035,อภ.วังเจ้า,TH/W_/63/อภ.วังเจ้า,TH/W_/63,30112,14994,15118,9102
2036,อภ.วังเหนือ,TH/N_/52/อภ.วังเหนือ,TH/N_/52,36982,18414,18568,13196
2037,อภ.วังโป่ง,TH/CT/67/อภ.วังโป่ง,TH/CT/67,28365,14308,14057,9215
2038,อภ.วัฒนานคร,TH/E_/27/อภ.วัฒนานคร,TH/E_/27,76500,38006,38494,26653
2039,อภ.วัดสิงห์,TH/CT/18/อภ.วัดสิงห์,TH/CT/18,22076,11418,10658,8976
2040,อภ.วัดเพลง,TH/W_/70/อภ.วัดเพลง,TH/W_/70,10780,5658,5122,3624
2041,อภ.วัดโบสถ์,TH/CT/65/อภ.วัดโบสถ์,TH/CT/65,29561,14929,14632,11136
2042,อภ.วานรนิวาส,TH/NE/47/อภ.วานรนิวาส,TH/NE/47,120399,60437,59962,34039
2043,อภ.วาปีปทุม,TH/NE/44/อภ.วาปีปทุม,TH/NE/44,107506,54062,53444,30363
2044,อภ.วาริชภูมิ,TH/NE/47/อภ.วาริชภูมิ,TH/NE/47,36051,18251,17800,12143
2045,อภ.วารินชำราบ,TH/NE/34/อภ.วารินชำราบ,TH/NE/34,92373,46457,45916,30328
2046,อภ.วิภาวดี,TH/S_/84/อภ.วิภาวดี,TH/S_/84,15658,7521,8137,7312
2047,อภ.วิหารแดง,TH/CT/19/อภ.วิหารแดง,TH/CT/19,33139,16910,16229,11969
2048,อภ.วิเชียรบุรี,TH/CT/67/อภ.วิเชียรบุรี,TH/CT/67,100349,50724,49625,33391
2049,อภ.วิเศษชัยชาญ,TH/CT/15/อภ.วิเศษชัยชาญ,TH/CT/15,51005,26492,24513,18066
2050,อภ.ศรีณรงค์,TH/S_/32/อภ.ศรีณรงค์,TH/S_/32,46835,23244,23591,11511
2051,อภ.ศรีธาตุ,TH/NE/41/อภ.ศรีธาตุ,TH/NE/41,23703,11915,11788,6619
2052,อภ.ศรีนคร,TH/CT/64/อภ.ศรีนคร,TH/CT/64,22590,11581,11009,8157
2053,อภ.ศรีนครินทร์,TH/S_/93/อภ.ศรีนครินทร์,TH/S_/93,10458,5320,5138,3604
2054,อภ.ศรีบรรพต,TH/S_/93/อภ.ศรีบรรพต,TH/S_/93,17984,8976,9008,6869
2055,อภ.ศรีบุญเรือง,TH/NE/39/อภ.ศรีบุญเรือง,TH/NE/39,90494,44876,45618,24946
2056,อภ.ศรีประจันต์,TH/CT/72/อภ.ศรีประจันต์,TH/CT/72,40379,21094,19285,14997
2057,อภ.ศรีมหาโพธิ,TH/E_/25/อภ.ศรีมหาโพธิ,TH/E_/25,72778,37134,35644,50971
2058,อภ.ศรีมโหสถ,TH/E_/25/อภ.ศรีมโหสถ,TH/E_/25,13265,6755,6510,6358
2059,อภ.ศรีรัตนะ,TH/NE/33/อภ.ศรีรัตนะ,TH/NE/33,48551,24393,24158,11513
2060,อภ.ศรีราชา,TH/E_/ชลบุรี/อภ.ศรีราชา,TH/E_/ชลบุรี,55792,27877,27915,46958
2061,อภ.ศรีวิไล,TH/NE/38/อภ.ศรีวิไล,TH/NE/38,28905,14347,14558,9469
2062,อภ.ศรีสงคราม,TH/NE/48/อภ.ศรีสงคราม,TH/NE/48,64528,32376,32152,19186
2063,อภ.ศรีสมเด็จ,TH/NE/45/อภ.ศรีสมเด็จ,TH/NE/45,36201,17292,18909,10992
2064,อภ.ศรีสวัสดิ์,TH/W_/71/อภ.ศรีสวัสดิ์,TH/W_/71,25819,12514,13305,10010
2065,อภ.ศรีสัชนาลัย,TH/CT/64/อภ.ศรีสัชนาลัย,TH/CT/64,69915,35582,34333,26755
2066,อภ.ศรีสาคร,TH/S_/96/อภ.ศรีสาคร,TH/S_/96,36308,17886,18422,9408
2067,อภ.ศรีสำโรง,TH/CT/64/อภ.ศรีสำโรง,TH/CT/64,61627,32042,29585,22418
2068,อภ.ศรีเชียงใหม่,TH/NE/43/อภ.ศรีเชียงใหม่,TH/NE/43,23647,11951,11696,7346
2069,อภ.ศรีเทพ,TH/CT/67/อภ.ศรีเทพ,TH/CT/67,56974,28628,28346,19427
2070,อภ.ศรีเมืองใหม่,TH/NE/34/อภ.ศรีเมืองใหม่,TH/NE/34,66769,33137,33632,19181
2071,อภ.ศิลาลาด,TH/NE/33/อภ.ศิลาลาด,TH/NE/33,19788,9809,9979,5297
2072,อภ.ศีขรภูมิ,TH/S_/32/อภ.ศีขรภูมิ,TH/S_/32,130294,65575,64719,32352
2073,อภ.สตึก,TH/NE/31/อภ.สตึก,TH/NE/31,98920,49549,49371,27026
2074,อภ.สทิงพระ,TH/S_/90/อภ.สทิงพระ,TH/S_/90,45191,23127,22064,13716
2075,อภ.สนม,TH/S_/32/อภ.สนม,TH/S_/32,38649,19199,19450,10610
2076,อภ.สนามชัยเขต,TH/E_/24/อภ.สนามชัยเขต,TH/E_/24,70677,35268,35409,22715
2077,อภ.สบปราบ,TH/N_/52/อภ.สบปราบ,TH/N_/52,21312,10807,10505,6604
2078,อภ.สบเมย,TH/N_/58/อภ.สบเมย,TH/N_/58,45990,22622,23368,17050
2079,อภ.สมเด็จ,TH/NE/46/อภ.สมเด็จ,TH/NE/46,54994,27745,27249,17433
2080,อภ.สรรคบุรี,TH/CT/18/อภ.สรรคบุรี,TH/CT/18,61397,31943,29454,22100
2081,อภ.สรรพยา,TH/CT/18/อภ.สรรพยา,TH/CT/18,30938,15918,15020,11652
2082,อภ.สระโบสถ์,TH/CT/16/อภ.สระโบสถ์,TH/CT/16,14110,6962,7148,5244
2083,อภ.สระใคร,TH/NE/43/อภ.สระใคร,TH/NE/43,26541,13167,13374,8200
2084,อภ.สร้างคอม,TH/NE/41/อภ.สร้างคอม,TH/NE/41,21878,10911,10967,6482
2085,อภ.สวนผึ้ง,TH/W_/70/อภ.สวนผึ้ง,TH/W_/70,46550,22278,24272,14477
2086,อภ.สวรรคโลก,TH/CT/64/อภ.สวรรคโลก,TH/CT/64,50441,26216,24225,20004
2087,อภ.สวี,TH/S_/86/อภ.สวี,TH/S_/86,70017,35160,34857,32255
2088,อภ.สว่างวีระวงศ์,TH/NE/34/อภ.สว่างวีระวงศ์,TH/NE/34,31173,15527,15646,9133
2089,อภ.สว่างอารมณ์,TH/CT/61/อภ.สว่างอารมณ์,TH/CT/61,29985,15039,14946,10929
2090,อภ.สว่างแดนดิน,TH/NE/47/อภ.สว่างแดนดิน,TH/NE/47,128262,64475,63787,37085
2091,อภ.สหัสขันธ์,TH/NE/46/อภ.สหัสขันธ์,TH/NE/46,34631,17426,17205,10211
2092,อภ.สอง,TH/N_/54/อภ.สอง,TH/N_/54,42360,21574,20786,16078
2093,อภ.สองพี่น้อง,TH/CT/72/อภ.สองพี่น้อง,TH/CT/72,110668,56363,54305,35842
2094,อภ.สองแคว,TH/N_/55/อภ.สองแคว,TH/N_/55,12409,5996,6413,3780
2095,อภ.สอยดาว,TH/E_/22/อภ.สอยดาว,TH/E_/22,37457,18548,18909,14953
2096,อภ.สะบ้าย้อย,TH/S_/90/อภ.สะบ้าย้อย,TH/S_/90,78514,38753,39761,19054
2097,อภ.สะเดา,TH/S_/90/อภ.สะเดา,TH/S_/90,58532,29123,29409,21237
2098,อภ.สะเมิง,TH/N_/เชียงใหม่/อภ.สะเมิง,TH/N_/เชียงใหม่,18269,8967,9302,6038
2099,อภ.สังขละบุรี,TH/W_/71/อภ.สังขละบุรี,TH/W_/71,42073,20312,21761,12201
2100,อภ.สังขะ,TH/S_/32/อภ.สังขะ,TH/S_/32,127044,63153,63891,34340
2101,อภ.สังคม,TH/NE/43/อภ.สังคม,TH/NE/43,22236,10948,11288,7139
2102,อภ.สัตหีบ,TH/E_/ชลบุรี/อภ.สัตหีบ,TH/E_/ชลบุรี,52242,26156,26086,29194
2103,อภ.สันกำแพง,TH/N_/เชียงใหม่/อภ.สันกำแพง,TH/N_/เชียงใหม่,42784,22577,20207,22383
2104,อภ.สันติสุข,TH/N_/55/อภ.สันติสุข,TH/N_/55,15706,7660,8046,5102
2105,อภ.สันทราย,TH/N_/เชียงใหม่/อภ.สันทราย,TH/N_/เชียงใหม่,20157,10695,9462,10016
2106,อภ.สันป่าตอง,TH/N_/เชียงใหม่/อภ.สันป่าตอง,TH/N_/เชียงใหม่,59795,31623,28172,25432
2107,อภ.สากเหล็ก,TH/CT/66/อภ.สากเหล็ก,TH/CT/66,18110,9115,8995,6086
2108,อภ.สามง่าม,TH/CT/66/อภ.สามง่าม,TH/CT/66,25804,13007,12797,8734
2109,อภ.สามชัย,TH/NE/46/อภ.สามชัย,TH/NE/46,25412,12505,12907,7510
2110,อภ.สามชุก,TH/CT/72/อภ.สามชุก,TH/CT/72,39921,20766,19155,14744
2111,อภ.สามพราน,TH/CT/73/อภ.สามพราน,TH/CT/73,99471,52195,47276,49095
2112,อภ.สามร้อยยอด,TH/W_/ประจวบคีรีขันธ์/อภ.สามร้อยยอด,TH/W_/ประจวบคีรีขันธ์,31482,15840,15642,12266
2113,อภ.สามเงา,TH/W_/63/อภ.สามเงา,TH/W_/63,25718,13035,12683,9447
2114,อภ.สามโก้,TH/CT/15/อภ.สามโก้,TH/CT/15,8412,4340,4072,2833
2115,อภ.สามโคก,TH/CT/ปทุมธานี/อภ.สามโคก,TH/CT/ปทุมธานี,44849,23140,21709,19446
2116,อภ.สายบุรี,TH/S_/94/อภ.สายบุรี,TH/S_/94,56651,28910,27741,13457
2117,อภ.สารภี,TH/N_/เชียงใหม่/อภ.สารภี,TH/N_/เชียงใหม่,46304,24611,21693,22364
2118,อภ.สำโรง,TH/NE/34/อภ.สำโรง,TH/NE/34,54159,27035,27124,14544
2119,อภ.สำโรงทาบ,TH/S_/32/อภ.สำโรงทาบ,TH/S_/32,50354,25092,25262,11752
2120,อภ.สิงหนคร,TH/S_/90/อภ.สิงหนคร,TH/S_/90,44125,22594,21531,14664
2121,อภ.สิชล,TH/S_/นครศรีธรรมราช/อภ.สิชล,TH/S_/นครศรีธรรมราช,81686,41128,40558,28665
2122,อภ.สิรินธร,TH/NE/34/อภ.สิรินธร,TH/NE/34,43268,21230,22038,14327
2123,อภ.สิเกา,TH/S_/92/อภ.สิเกา,TH/S_/92,34716,17193,17523,12505
2124,อภ.สีคิ้ว,TH/NE/30/อภ.สีคิ้ว,TH/NE/30,86472,43524,42948,31766
2125,อภ.สีชมพู,TH/NE/ขอนแก่น/อภ.สีชมพู,TH/NE/ขอนแก่น,74160,37320,36840,22189
2126,อภ.สีดา,TH/NE/30/อภ.สีดา,TH/NE/30,20139,10096,10043,5855
2127,อภ.สุขสำราญ,TH/S_/85/อภ.สุขสำราญ,TH/S_/85,14336,7176,7160,4528
2128,อภ.สุคิริน,TH/S_/96/อภ.สุคิริน,TH/S_/96,22978,11265,11713,7392
2129,อภ.สุวรรณคูหา,TH/NE/39/อภ.สุวรรณคูหา,TH/NE/39,53713,26763,26950,14997
2130,อภ.สุวรรณภูมิ,TH/NE/45/อภ.สุวรรณภูมิ,TH/NE/45,105565,53069,52496,29543
2131,อภ.สุไหงปาดี,TH/S_/96/อภ.สุไหงปาดี,TH/S_/96,48136,24403,23733,12081
2132,อภ.สุไหงโกลก,TH/S_/96/อภ.สุไหงโกลก,TH/S_/96,37590,19433,18157,10994
2133,อภ.สูงเนิน,TH/NE/30/อภ.สูงเนิน,TH/NE/30,72332,37001,35331,29210
2134,อภ.สูงเม่น,TH/N_/54/อภ.สูงเม่น,TH/N_/54,69275,36121,33154,27792
2135,อภ.ส่องดาว,TH/NE/47/อภ.ส่องดาว,TH/NE/47,29520,14503,15017,7654
2136,อภ.หนองกี่,TH/NE/31/อภ.หนองกี่,TH/NE/31,57219,28441,28778,15337
2137,อภ.หนองกุงศรี,TH/NE/46/อภ.หนองกุงศรี,TH/NE/46,51177,25569,25608,15185
2138,อภ.หนองขาหย่าง,TH/CT/61/อภ.หนองขาหย่าง,TH/CT/61,15340,8077,7263,5773
2139,อภ.หนองจิก,TH/S_/94/อภ.หนองจิก,TH/S_/94,58930,29583,29347,13296
2140,อภ.หนองฉาง,TH/CT/61/อภ.หนองฉาง,TH/CT/61,34137,17566,16571,11772
2141,อภ.หนองนาคำ,TH/NE/ขอนแก่น/อภ.หนองนาคำ,TH/NE/ขอนแก่น,23780,11968,11812,6631
2142,อภ.หนองบัว,TH/CT/60/อภ.หนองบัว,TH/CT/60,54485,27476,27009,23201
2143,อภ.หนองบัวระเหว,TH/NE/36/อภ.หนองบัวระเหว,TH/NE/36,32643,16210,16433,11481
2144,อภ.หนองบัวแดง,TH/NE/36/อภ.หนองบัวแดง,TH/NE/36,93002,46333,46669,29387
2145,อภ.หนองบุญมาก,TH/NE/30/อภ.หนองบุญมาก,TH/NE/30,60793,30643,30150,18389
2146,อภ.หนองปรือ,TH/W_/71/อภ.หนองปรือ,TH/W_/71,27037,13330,13707,9492
2147,อภ.หนองพอก,TH/NE/45/อภ.หนองพอก,TH/NE/45,60039,29896,30143,16405
2148,อภ.หนองมะโมง,TH/CT/18/อภ.หนองมะโมง,TH/CT/18,12829,6503,6326,5093
2149,อภ.หนองม่วง,TH/CT/16/อภ.หนองม่วง,TH/CT/16,27909,14238,13671,11480
2150,อภ.หนองม่วงไข่,TH/N_/54/อภ.หนองม่วงไข่,TH/N_/54,12875,6852,6023,5049
2151,อภ.หนองวัวซอ,TH/NE/41/อภ.หนองวัวซอ,TH/NE/41,44907,22399,22508,11579
2152,อภ.หนองสองห้อง,TH/NE/ขอนแก่น/อภ.หนองสองห้อง,TH/NE/ขอนแก่น,71064,35745,35319,20412
2153,อภ.หนองสูง,TH/NE/49/อภ.หนองสูง,TH/NE/49,20793,10424,10369,7137
2154,อภ.หนองหงส์,TH/NE/31/อภ.หนองหงส์,TH/NE/31,35529,17596,17933,9319
2155,อภ.หนองหญ้าปล้อง,TH/W_/76/อภ.หนองหญ้าปล้อง,TH/W_/76,16300,8128,8172,6743
2156,อภ.หนองหญ้าไซ,TH/CT/72/อภ.หนองหญ้าไซ,TH/CT/72,46258,23680,22578,16317
2157,อภ.หนองหาน,TH/NE/41/อภ.หนองหาน,TH/NE/41,88787,44349,44438,26880
2158,อภ.หนองหิน,TH/NE/42/อภ.หนองหิน,TH/NE/42,20548,10154,10394,5998
2159,อภ.หนองฮี,TH/NE/45/อภ.หนองฮี,TH/NE/45,24379,12189,12190,6495
2160,อภ.หนองเรือ,TH/NE/ขอนแก่น/อภ.หนองเรือ,TH/NE/ขอนแก่น,83865,42394,41471,22879
2161,อภ.หนองเสือ,TH/CT/ปทุมธานี/อภ.หนองเสือ,TH/CT/ปทุมธานี,51672,26046,25626,16437
2162,อภ.หนองแค,TH/CT/19/อภ.หนองแค,TH/CT/19,67598,34696,32902,33527
2163,อภ.หนองแซง,TH/CT/19/อภ.หนองแซง,TH/CT/19,12991,6795,6196,4335
2164,อภ.หนองแสง,TH/NE/41/อภ.หนองแสง,TH/NE/41,23316,11661,11655,6715
2165,อภ.หนองโดน,TH/CT/19/อภ.หนองโดน,TH/CT/19,11528,5914,5614,4420
2166,อภ.หนองใหญ่,TH/E_/ชลบุรี/อภ.หนองใหญ่,TH/E_/ชลบุรี,15370,7665,7705,6594
2167,อภ.หนองไผ่,TH/CT/67/อภ.หนองไผ่,TH/CT/67,76312,38342,37970,24954
2168,อภ.หลังสวน,TH/S_/86/อภ.หลังสวน,TH/S_/86,56087,28629,27458,23726
2169,อภ.หล่มสัก,TH/CT/67/อภ.หล่มสัก,TH/CT/67,144549,73936,70613,48644
2170,อภ.หล่มเก่า,TH/CT/67/อภ.หล่มเก่า,TH/CT/67,60236,30715,29521,18739
2171,อภ.หว้านใหญ่,TH/NE/49/อภ.หว้านใหญ่,TH/NE/49,19759,9856,9903,6166
2172,อภ.หันคา,TH/CT/18/อภ.หันคา,TH/CT/18,41200,21262,19938,14492
2173,อภ.หัวตะพาน,TH/NE/37/อภ.หัวตะพาน,TH/NE/37,42342,21121,21221,10842
2174,อภ.หัวหิน,TH/W_/ประจวบคีรีขันธ์/อภ.หัวหิน,TH/W_/ประจวบคีรีขันธ์,52644,27221,25423,27972
2175,อภ.หัวไทร,TH/S_/นครศรีธรรมราช/อภ.หัวไทร,TH/S_/นครศรีธรรมราช,44248,22230,22018,17631
2176,อภ.หางดง,TH/N_/เชียงใหม่/อภ.หางดง,TH/N_/เชียงใหม่,75264,39820,35444,43174
2177,อภ.หาดสำราญ,TH/S_/92/อภ.หาดสำราญ,TH/S_/92,16903,8410,8493,4855
2178,อภ.หาดใหญ่,TH/S_/90/อภ.หาดใหญ่,TH/S_/90,30717,15957,14760,12806
2179,อภ.ห้วยกระเจา,TH/W_/71/อภ.ห้วยกระเจา,TH/W_/71,33726,17128,16598,11723
2180,อภ.ห้วยคต,TH/CT/61/อภ.ห้วยคต,TH/CT/61,20130,10170,9960,7408
2181,อภ.ห้วยทับทัน,TH/NE/33/อภ.ห้วยทับทัน,TH/NE/33,38903,19395,19508,8920
2182,อภ.ห้วยผึ้ง,TH/NE/46/อภ.ห้วยผึ้ง,TH/NE/46,14032,7099,6933,3912
2183,อภ.ห้วยยอด,TH/S_/92/อภ.ห้วยยอด,TH/S_/92,78643,39851,38792,26655
2184,อภ.ห้วยราช,TH/NE/31/อภ.ห้วยราช,TH/NE/31,32425,16319,16106,8164
2185,อภ.ห้วยเม็ก,TH/NE/46/อภ.ห้วยเม็ก,TH/NE/46,40061,19928,20133,11877
2186,อภ.ห้วยแถลง,TH/NE/30/อภ.ห้วยแถลง,TH/NE/30,70327,35007,35320,19280
2187,อภ.ห้างฉัตร,TH/N_/52/อภ.ห้างฉัตร,TH/N_/52,47643,24490,23153,19312
2188,อภ.องครักษ์,TH/CT/26/อภ.องครักษ์,TH/CT/26,62338,31637,30701,21977
2189,อภ.อมก๋อย,TH/N_/เชียงใหม่/อภ.อมก๋อย,TH/N_/เชียงใหม่,60831,30145,30686,22382
2190,อภ.อรัญประเทศ,TH/E_/27/อภ.อรัญประเทศ,TH/E_/27,74071,37651,36420,35808
2191,อภ.อัมพวา,TH/CT/75/อภ.อัมพวา,TH/CT/75,48085,24983,23102,15516
2192,อภ.อากาศอำนวย,TH/NE/47/อภ.อากาศอำนวย,TH/NE/47,54028,26893,27135,18555
2193,อภ.อาจสามารถ,TH/NE/45/อภ.อาจสามารถ,TH/NE/45,69666,34812,34854,18768
2194,อภ.อินทร์บุรี,TH/CT/17/อภ.อินทร์บุรี,TH/CT/17,49036,25472,23564,17555
2195,อภ.อุทัย,TH/CT/14/อภ.อุทัย,TH/CT/14,46467,24224,22243,21498
2196,อภ.อุทุมพรพิสัย,TH/NE/33/อภ.อุทุมพรพิสัย,TH/NE/33,102474,51551,50923,26147
2197,อภ.อุบลรัตน์,TH/NE/ขอนแก่น/อภ.อุบลรัตน์,TH/NE/ขอนแก่น,31491,15932,15559,8186
2198,อภ.อุ้มผาง,TH/W_/63/อภ.อุ้มผาง,TH/W_/63,43405,20847,22558,11095
2199,อภ.อู่ทอง,TH/CT/72/อภ.อู่ทอง,TH/CT/72,65194,33558,31636,21146
2200,อภ.อ่าวลึก,TH/S_/81/อภ.อ่าวลึก,TH/S_/81,46701,23453,23248,16328
2201,อภ.ฮอด,TH/N_/เชียงใหม่/อภ.ฮอด,TH/N_/เชียงใหม่,25563,12932,12631,9622
2202,อภ.เกษตรวิสัย,TH/NE/45/อภ.เกษตรวิสัย,TH/NE/45,73553,36798,36755,20769
2203,อภ.เกษตรสมบูรณ์,TH/NE/36/อภ.เกษตรสมบูรณ์,TH/NE/36,85455,42899,42556,24976
2204,อภ.เกาะกูด,TH/E_/23/อภ.เกาะกูด,TH/E_/23,2609,1255,1354,2020
2205,อภ.เกาะคา,TH/N_/52/อภ.เกาะคา,TH/N_/52,36230,18716,17514,13158
2206,อภ.เกาะจันทร์,TH/E_/ชลบุรี/อภ.เกาะจันทร์,TH/E_/ชลบุรี,26409,12870,13539,8383
2207,อภ.เกาะช้าง,TH/E_/23/อภ.เกาะช้าง,TH/E_/23,8596,4295,4301,5978
2208,อภ.เกาะพะงัน,TH/S_/84/อภ.เกาะพะงัน,TH/S_/84,10784,5300,5484,12194
2209,อภ.เกาะยาว,TH/S_/82/อภ.เกาะยาว,TH/S_/82,13666,6772,6894,5272
2210,อภ.เกาะลันตา,TH/S_/81/อภ.เกาะลันตา,TH/S_/81,34606,17105,17501,14403
2211,อภ.เก้าเลี้ยว,TH/CT/60/อภ.เก้าเลี้ยว,TH/CT/60,28581,14621,13960,10488
2212,อภ.เขมราฐ,TH/NE/34/อภ.เขมราฐ,TH/NE/34,31606,15783,15823,8945
2213,อภ.เขวาสินรินทร์,TH/S_/32/อภ.เขวาสินรินทร์,TH/S_/32,34413,17401,17012,9954
2214,อภ.เขาคิชฌกูฏ,TH/E_/22/อภ.เขาคิชฌกูฏ,TH/E_/22,12736,6469,6267,5467
2215,อภ.เขาค้อ,TH/CT/67/อภ.เขาค้อ,TH/CT/67,35065,17512,17553,11797
2216,อภ.เขาฉกรรจ์,TH/E_/27/อภ.เขาฉกรรจ์,TH/E_/27,50856,25369,25487,16118
2217,อภ.เขาชะเมา,TH/E_/21/อภ.เขาชะเมา,TH/E_/21,23669,11893,11776,11002
2218,อภ.เขาชัยสน,TH/S_/93/อภ.เขาชัยสน,TH/S_/93,30996,15807,15189,11443
2219,อภ.เขาพนม,TH/S_/81/อภ.เขาพนม,TH/S_/81,50112,24959,25153,17956
2220,อภ.เขาย้อย,TH/W_/76/อภ.เขาย้อย,TH/W_/76,23521,12048,11473,10176
2221,อภ.เขาวง,TH/NE/46/อภ.เขาวง,TH/NE/46,20990,10550,10440,8460
2222,อภ.เขาสมิง,TH/E_/23/อภ.เขาสมิง,TH/E_/23,39935,20050,19885,17646
2223,อภ.เขาสวนกวาง,TH/NE/ขอนแก่น/อภ.เขาสวนกวาง,TH/NE/ขอนแก่น,21453,10744,10709,6333
2224,อภ.เขื่องใน,TH/NE/34/อภ.เขื่องใน,TH/NE/34,102868,51887,50981,27748
2225,อภ.เคียนซา,TH/S_/84/อภ.เคียนซา,TH/S_/84,27713,13827,13886,11194
2226,อภ.เจริญศิลป์,TH/NE/47/อภ.เจริญศิลป์,TH/NE/47,38292,18987,19305,10474
2227,อภ.เจาะไอร้อง,TH/S_/96/อภ.เจาะไอร้อง,TH/S_/96,40953,20503,20450,9694
2228,อภ.เฉลิมพระเกียรติ,TH/CT/19/อภ.เฉลิมพระเกียรติ,TH/CT/19,29585,15187,14398,12441
2229,อภ.เฉลิมพระเกียรติ,TH/NE/30/อภ.เฉลิมพระเกียรติ,TH/NE/30,30992,15836,15156,9361
2230,อภ.เฉลิมพระเกียรติ,TH/NE/31/อภ.เฉลิมพระเกียรติ,TH/NE/31,12069,6050,6019,3489
2231,อภ.เฉลิมพระเกียรติ,TH/N_/55/อภ.เฉลิมพระเกียรติ,TH/N_/55,9823,4791,5032,3366
2232,อภ.เฉลิมพระเกียรติ,TH/S_/นครศรีธรรมราช/อภ.เฉลิมพระเกียรติ,TH/S_/นครศรีธรรมราช,22320,11219,11101,7920
2233,อภ.เชียงกลาง,TH/N_/55/อภ.เชียงกลาง,TH/N_/55,17590,8837,8753,5762
2234,อภ.เชียงขวัญ,TH/NE/45/อภ.เชียงขวัญ,TH/NE/45,27352,13925,13427,8117
2235,อภ.เชียงของ,TH/N_/57/อภ.เชียงของ,TH/N_/57,25304,12891,12413,10431
2236,อภ.เชียงคาน,TH/NE/42/อภ.เชียงคาน,TH/NE/42,38224,19196,19028,13862
2237,อภ.เชียงคำ,TH/N_/56/อภ.เชียงคำ,TH/N_/56,55632,27869,27763,21292
2238,อภ.เชียงดาว,TH/N_/เชียงใหม่/อภ.เชียงดาว,TH/N_/เชียงใหม่,26589,13579,13010,11389
2239,อภ.เชียงม่วน,TH/N_/56/อภ.เชียงม่วน,TH/N_/56,9793,4945,4848,3912
2240,อภ.เชียงยืน,TH/NE/44/อภ.เชียงยืน,TH/NE/44,56082,28411,27671,17915
2241,อภ.เชียงแสน,TH/N_/57/อภ.เชียงแสน,TH/N_/57,48718,24964,23754,21354
2242,อภ.เชียรใหญ่,TH/S_/นครศรีธรรมราช/อภ.เชียรใหญ่,TH/S_/นครศรีธรรมราช,40517,20235,20282,14387
2243,อภ.เซกา,TH/NE/38/อภ.เซกา,TH/NE/38,73205,36286,36919,22627
2244,อภ.เดชอุดม,TH/NE/34/อภ.เดชอุดม,TH/NE/34,131567,65369,66198,49666
2245,อภ.เดิมบางนางบวช,TH/CT/72/อภ.เดิมบางนางบวช,TH/CT/72,41756,21528,20228,15142
2246,อภ.เด่นชัย,TH/N_/54/อภ.เด่นชัย,TH/N_/54,19704,9632,10072,8371
2247,อภ.เต่างอย,TH/NE/47/อภ.เต่างอย,TH/NE/47,24372,12164,12208,8580
2248,อภ.เถิน,TH/N_/52/อภ.เถิน,TH/N_/52,33730,17066,16664,11399
2249,อภ.เทพสถิต,TH/NE/36/อภ.เทพสถิต,TH/NE/36,65521,32451,33070,23676
2250,อภ.เทพา,TH/S_/90/อภ.เทพา,TH/S_/90,60373,29286,31087,16505
2251,อภ.เทพารักษ์,TH/NE/30/อภ.เทพารักษ์,TH/NE/30,25305,12534,12771,8445
2252,อภ.เทิง,TH/N_/57/อภ.เทิง,TH/N_/57,74839,37653,37186,28705
2253,อภ.เนินขาม,TH/CT/18/อภ.เนินขาม,TH/CT/18,10866,5547,5319,3938
2254,อภ.เนินมะปราง,TH/CT/65/อภ.เนินมะปราง,TH/CT/65,38527,19374,19153,14635
2255,อภ.เนินสง่า,TH/NE/36/อภ.เนินสง่า,TH/NE/36,25977,13135,12842,8428
2256,อภ.เบญจลักษ์,TH/NE/33/อภ.เบญจลักษ์,TH/NE/33,35961,17849,18112,9173
2257,อภ.เบตง,TH/S_/95/อภ.เบตง,TH/S_/95,36052,17461,18591,15649
2258,อภ.เปือยน้อย,TH/NE/ขอนแก่น/อภ.เปือยน้อย,TH/NE/ขอนแก่น,14209,7022,7187,3802
2259,อภ.เฝ้าไร่,TH/NE/43/อภ.เฝ้าไร่,TH/NE/43,39970,20007,19963,11424
2260,อภ.เพ็ญ,TH/NE/41/อภ.เพ็ญ,TH/NE/41,96417,48210,48207,29169
2261,อภ.เมยวดี,TH/NE/45/อภ.เมยวดี,TH/NE/45,23211,11765,11446,6832
2262,อภ.เมืองกระบี่,TH/S_/81/อภ.เมืองกระบี่,TH/S_/81,73674,37265,36409,38326
2263,อภ.เมืองกาญจนบุรี,TH/W_/71/อภ.เมืองกาญจนบุรี,TH/W_/71,98917,43461,55456,38972
2264,อภ.เมืองกาฬสินธุ์,TH/NE/46/อภ.เมืองกาฬสินธุ์,TH/NE/46,80856,40984,39872,25719
2265,อภ.เมืองกำแพงเพชร,TH/CT/62/อภ.เมืองกำแพงเพชร,TH/CT/62,135521,68784,66737,52519
2266,อภ.เมืองขอนแก่น,TH/NE/ขอนแก่น/อภ.เมืองขอนแก่น,TH/NE/ขอนแก่น,148527,75580,72947,65099
2267,อภ.เมืองจันทบุรี,TH/E_/22/อภ.เมืองจันทบุรี,TH/E_/22,46457,24365,22092,21762
2268,อภ.เมืองจันทร์,TH/NE/33/อภ.เมืองจันทร์,TH/NE/33,17837,8818,9019,4356
2269,อภ.เมืองฉะเชิงเทรา,TH/E_/24/อภ.เมืองฉะเชิงเทรา,TH/E_/24,122904,62936,59968,51158
2270,อภ.เมืองชลบุรี,TH/E_/ชลบุรี/อภ.เมืองชลบุรี,TH/E_/ชลบุรี,41170,21136,20034,26137
2271,อภ.เมืองชัยนาท,TH/CT/18/อภ.เมืองชัยนาท,TH/CT/18,22843,11814,11029,8632
2272,อภ.เมืองชัยภูมิ,TH/NE/36/อภ.เมืองชัยภูมิ,TH/NE/36,136885,69912,66973,53889
2273,อภ.เมืองชุมพร,TH/S_/86/อภ.เมืองชุมพร,TH/S_/86,92326,46472,45854,44007
2274,อภ.เมืองตรัง,TH/S_/92/อภ.เมืองตรัง,TH/S_/92,94771,49012,45759,39876
2275,อภ.เมืองตราด,TH/E_/23/อภ.เมืองตราด,TH/E_/23,74314,38181,36133,35026
2276,อภ.เมืองตาก,TH/W_/63/อภ.เมืองตาก,TH/W_/63,74528,37423,37105,29220
2277,อภ.เมืองนครนายก,TH/CT/26/อภ.เมืองนครนายก,TH/CT/26,84468,42220,42248,33854
2278,อภ.เมืองนครปฐม,TH/CT/73/อภ.เมืองนครปฐม,TH/CT/73,172687,89749,82938,66425
2279,อภ.เมืองนครพนม,TH/NE/48/อภ.เมืองนครพนม,TH/NE/48,118033,58543,59490,35688
2280,อภ.เมืองนครราชสีมา,TH/NE/30/อภ.เมืองนครราชสีมา,TH/NE/30,231176,120949,110227,109748
2281,อภ.เมืองนครศรีธรรมราช,TH/S_/นครศรีธรรมราช/อภ.เมืองนครศรีธรรมราช,TH/S_/นครศรีธรรมราช,158040,79953,78087,61795
2282,อภ.เมืองนครสวรรค์,TH/CT/60/อภ.เมืองนครสวรรค์,TH/CT/60,159736,82180,77556,69809
2283,อภ.เมืองนนทบุรี,TH/CT/12/อภ.เมืองนนทบุรี,TH/CT/12,57515,30820,26695,30511
2284,อภ.เมืองนราธิวาส,TH/S_/96/อภ.เมืองนราธิวาส,TH/S_/96,84574,42439,42135,25961
2285,อภ.เมืองน่าน,TH/N_/55/อภ.เมืองน่าน,TH/N_/55,62705,31301,31404,24462
2286,อภ.เมืองบึงกาฬ,TH/NE/38/อภ.เมืองบึงกาฬ,TH/NE/38,58660,29194,29466,18487
2287,อภ.เมืองบุรีรัมย์,TH/NE/31/อภ.เมืองบุรีรัมย์,TH/NE/31,174181,87196,86985,52417
2288,อภ.เมืองปทุมธานี,TH/CT/ปทุมธานี/อภ.เมืองปทุมธานี,TH/CT/ปทุมธานี,128028,67126,60902,66691
2289,อภ.เมืองประจวบคีรีขันธ์,TH/W_/ประจวบคีรีขันธ์/อภ.เมืองประจวบคีรีขันธ์,TH/W_/ประจวบคีรีขันธ์,65040,32461,32579,26113
2290,อภ.เมืองปราจีนบุรี,TH/E_/25/อภ.เมืองปราจีนบุรี,TH/E_/25,88319,42743,45576,35262
2291,อภ.เมืองปัตตานี,TH/S_/94/อภ.เมืองปัตตานี,TH/S_/94,91662,48214,43448,30960
2292,อภ.เมืองปาน,TH/N_/52/อภ.เมืองปาน,TH/N_/52,32829,16393,16436,11923
2293,อภ.เมืองพะเยา,TH/N_/56/อภ.เมืองพะเยา,TH/N_/56,43480,22378,21102,17322
2294,อภ.เมืองพังงา,TH/S_/82/อภ.เมืองพังงา,TH/S_/82,31427,15916,15511,12247
2295,อภ.เมืองพัทลุง,TH/S_/93/อภ.เมืองพัทลุง,TH/S_/93,88477,46067,42410,33671
2296,อภ.เมืองพิจิตร,TH/CT/66/อภ.เมืองพิจิตร,TH/CT/66,72958,37658,35300,26105
2297,อภ.เมืองพิษณุโลก,TH/CT/65/อภ.เมืองพิษณุโลก,TH/CT/65,179648,92778,86870,84862
2298,อภ.เมืองภูเก็ต,TH/S_/83/อภ.เมืองภูเก็ต,TH/S_/83,43747,23210,20537,30443
2299,อภ.เมืองมหาสารคาม,TH/NE/44/อภ.เมืองมหาสารคาม,TH/NE/44,101823,51951,49872,35596
2300,อภ.เมืองมุกดาหาร,TH/NE/49/อภ.เมืองมุกดาหาร,TH/NE/49,79674,39598,40076,26572
2301,อภ.เมืองยะลา,TH/S_/95/อภ.เมืองยะลา,TH/S_/95,76318,38675,37643,18681
2302,อภ.เมืองยาง,TH/NE/30/อภ.เมืองยาง,TH/NE/30,19706,9755,9951,5457
2303,อภ.เมืองยโสธร,TH/NE/35/อภ.เมืองยโสธร,TH/NE/35,108102,53685,54417,38332
2304,อภ.เมืองระนอง,TH/S_/85/อภ.เมืองระนอง,TH/S_/85,70234,34654,35580,37744
2305,อภ.เมืองระยอง,TH/E_/21/อภ.เมืองระยอง,TH/E_/21,101478,51510,49968,64483
2306,อภ.เมืองราชบุรี,TH/W_/70/อภ.เมืองราชบุรี,TH/W_/70,123241,63207,60034,47697
2307,อภ.เมืองร้อยเอ็ด,TH/NE/45/อภ.เมืองร้อยเอ็ด,TH/NE/45,110370,55953,54417,40996
2308,อภ.เมืองลพบุรี,TH/CT/16/อภ.เมืองลพบุรี,TH/CT/16,103674,51436,52238,41105
2309,อภ.เมืองลำปาง,TH/N_/52/อภ.เมืองลำปาง,TH/N_/52,90527,45973,44554,38173
2310,อภ.เมืองลำพูน,TH/N_/51/อภ.เมืองลำพูน,TH/N_/51,58890,30961,27929,27356
2311,อภ.เมืองศรีสะเกษ,TH/NE/33/อภ.เมืองศรีสะเกษ,TH/NE/33,87157,44397,42760,26287
2312,อภ.เมืองสกลนคร,TH/NE/47/อภ.เมืองสกลนคร,TH/NE/47,113059,57161,55898,41103
2313,อภ.เมืองสงขลา,TH/S_/90/อภ.เมืองสงขลา,TH/S_/90,15260,7933,7327,5479
2314,อภ.เมืองสตูล,TH/S_/91/อภ.เมืองสตูล,TH/S_/91,65777,33330,32447,18364
2315,อภ.เมืองสมุทรปราการ,TH/CT/11/อภ.เมืองสมุทรปราการ,TH/CT/11,126477,66480,59997,58292
2316,อภ.เมืองสมุทรสงคราม,TH/CT/75/อภ.เมืองสมุทรสงคราม,TH/CT/75,78593,40920,37673,31968
2317,อภ.เมืองสมุทรสาคร,TH/CT/74/อภ.เมืองสมุทรสาคร,TH/CT/74,203571,106186,97385,113256
2318,อภ.เมืองสรวง,TH/NE/45/อภ.เมืองสรวง,TH/NE/45,13653,6835,6818,3755
2319,อภ.เมืองสระบุรี,TH/CT/19/อภ.เมืองสระบุรี,TH/CT/19,47248,21946,25302,19624
2320,อภ.เมืองสระแก้ว,TH/E_/27/อภ.เมืองสระแก้ว,TH/E_/27,86540,43005,43535,29275
2321,อภ.เมืองสิงห์บุรี,TH/CT/17/อภ.เมืองสิงห์บุรี,TH/CT/17,36511,19462,17049,13204
2322,อภ.เมืองสุพรรณบุรี,TH/CT/72/อภ.เมืองสุพรรณบุรี,TH/CT/72,107539,56324,51215,38078
2323,อภ.เมืองสุราษฎร์ธานี,TH/S_/84/อภ.เมืองสุราษฎร์ธานี,TH/S_/84,17879,9172,8707,7371
2324,อภ.เมืองสุรินทร์,TH/S_/32/อภ.เมืองสุรินทร์,TH/S_/32,217617,109736,107881,75576
2325,อภ.เมืองสุโขทัย,TH/CT/64/อภ.เมืองสุโขทัย,TH/CT/64,61079,31649,29430,22659
2326,อภ.เมืองหนองคาย,TH/NE/43/อภ.เมืองหนองคาย,TH/NE/43,74975,37789,37186,24063
2327,อภ.เมืองหนองบัวลำภู,TH/NE/39/อภ.เมืองหนองบัวลำภู,TH/NE/39,102106,50904,51202,30604
2328,อภ.เมืองอำนาจเจริญ,TH/NE/37/อภ.เมืองอำนาจเจริญ,TH/NE/37,97102,48458,48644,30848
2329,อภ.เมืองอุดรธานี,TH/NE/41/อภ.เมืองอุดรธานี,TH/NE/41,184008,93893,90115,69678
2330,อภ.เมืองอุตรดิตถ์,TH/N_/53/อภ.เมืองอุตรดิตถ์,TH/N_/53,46016,23551,22465,17719
2331,อภ.เมืองอุทัยธานี,TH/CT/61/อภ.เมืองอุทัยธานี,TH/CT/61,35499,18472,17027,13501
2332,อภ.เมืองอุบลราชธานี,TH/NE/34/อภ.เมืองอุบลราชธานี,TH/NE/34,95603,48438,47165,35139
2333,อภ.เมืองอ่างทอง,TH/CT/15/อภ.เมืองอ่างทอง,TH/CT/15,43739,22997,20742,16782
2334,อภ.เมืองเชียงราย,TH/N_/57/อภ.เมืองเชียงราย,TH/N_/57,108994,57126,51868,51067
2335,อภ.เมืองเชียงใหม่,TH/N_/เชียงใหม่/อภ.เมืองเชียงใหม่,TH/N_/เชียงใหม่,14041,7426,6615,11264
2336,อภ.เมืองเพชรบุรี,TH/W_/76/อภ.เมืองเพชรบุรี,TH/W_/76,90197,47885,42312,34794
2337,อภ.เมืองเพชรบูรณ์,TH/CT/67/อภ.เมืองเพชรบูรณ์,TH/CT/67,160579,79880,80699,62078
2338,อภ.เมืองเลย,TH/NE/42/อภ.เมืองเลย,TH/NE/42,59073,29078,29995,23494
2339,อภ.เมืองแพร่,TH/N_/54/อภ.เมืองแพร่,TH/N_/54,62521,32949,29572,27253
2340,อภ.เมืองแม่ฮ่องสอน,TH/N_/58/อภ.เมืองแม่ฮ่องสอน,TH/N_/58,56167,27839,28328,22862
2341,อภ.เรณูนคร,TH/NE/48/อภ.เรณูนคร,TH/NE/48,41497,20671,20826,12812
2342,อภ.เลาขวัญ,TH/W_/71/อภ.เลาขวัญ,TH/W_/71,53398,26800,26598,18105
2343,อภ.เลิงนกทา,TH/NE/35/อภ.เลิงนกทา,TH/NE/35,89262,44771,44491,28249
2344,อภ.เวียงชัย,TH/N_/57/อภ.เวียงชัย,TH/N_/57,38840,19929,18911,15263
2345,อภ.เวียงป่าเป้า,TH/N_/57/อภ.เวียงป่าเป้า,TH/N_/57,61236,30851,30385,24366
2346,อภ.เวียงสระ,TH/S_/84/อภ.เวียงสระ,TH/S_/84,17101,8677,8424,6796
2347,อภ.เวียงสา,TH/N_/55/อภ.เวียงสา,TH/N_/55,66983,33310,33673,24382
2348,อภ.เวียงเก่า,TH/NE/ขอนแก่น/อภ.เวียงเก่า,TH/NE/ขอนแก่น,20004,10095,9909,5597
2349,อภ.เวียงเชียงรุ้ง,TH/N_/57/อภ.เวียงเชียงรุ้ง,TH/N_/57,23921,12059,11862,8945
2350,อภ.เวียงแก่น,TH/N_/57/อภ.เวียงแก่น,TH/N_/57,36353,17937,18416,13030
2351,อภ.เวียงแหง,TH/N_/เชียงใหม่/อภ.เวียงแหง,TH/N_/เชียงใหม่,53924,26731,27193,9414
2352,อภ.เสนา,TH/CT/14/อภ.เสนา,TH/CT/14,31194,15994,15200,9832
2353,อภ.เสนางคนิคม,TH/NE/37/อภ.เสนางคนิคม,TH/NE/37,35060,17658,17402,10446
2354,อภ.เสริมงาม,TH/N_/52/อภ.เสริมงาม,TH/N_/52,22215,11069,11146,7622
2355,อภ.เสลภูมิ,TH/NE/45/อภ.เสลภูมิ,TH/NE/45,90389,45431,44958,24931
2356,อภ.เสาไห้,TH/CT/19/อภ.เสาไห้,TH/CT/19,22179,11591,10588,8227
2357,อภ.เสิงสาง,TH/NE/30/อภ.เสิงสาง,TH/NE/30,56958,28676,28282,17130
2358,อภ.เหนือคลอง,TH/S_/81/อภ.เหนือคลอง,TH/S_/81,59937,30250,29687,20157
2359,อภ.เหล่าเสือโก้ก,TH/NE/34/อภ.เหล่าเสือโก้ก,TH/NE/34,27964,13909,14055,7797
2360,อภ.เอราวัณ,TH/NE/42/อภ.เอราวัณ,TH/NE/42,34099,17048,17051,11420
2361,อภ.แกดำ,TH/NE/44/อภ.แกดำ,TH/NE/44,24395,12124,12271,6526
2362,อภ.แกลง,TH/E_/21/อภ.แกลง,TH/E_/21,67483,34943,32540,30962
2363,อภ.แก่งกระจาน,TH/W_/76/อภ.แก่งกระจาน,TH/W_/76,33245,16041,17204,15166
2364,อภ.แก่งคอย,TH/CT/19/อภ.แก่งคอย,TH/CT/19,70005,35415,34590,30672
2365,อภ.แก่งหางแมว,TH/E_/22/อภ.แก่งหางแมว,TH/E_/22,42327,21052,21275,20687
2366,อภ.แก้งคร้อ,TH/NE/36/อภ.แก้งคร้อ,TH/NE/36,72805,36448,36357,24951
2367,อภ.แก้งสนามนาง,TH/NE/30/อภ.แก้งสนามนาง,TH/NE/30,36835,18505,18330,10673
2368,อภ.แคนดง,TH/NE/31/อภ.แคนดง,TH/NE/31,26885,13529,13356,7327
2369,อภ.แจ้ห่ม,TH/N_/52/อภ.แจ้ห่ม,TH/N_/52,35151,17802,17349,13142
2370,อภ.แปลงยาว,TH/E_/24/อภ.แปลงยาว,TH/E_/24,21082,10396,10686,10862
2371,อภ.แม่จริม,TH/N_/55/อภ.แม่จริม,TH/N_/55,16257,7970,8287,4892
2372,อภ.แม่จัน,TH/N_/57/อภ.แม่จัน,TH/N_/57,70353,36351,34002,28143
2373,อภ.แม่ทะ,TH/N_/52/อภ.แม่ทะ,TH/N_/52,28276,14235,14041,10681
2374,อภ.แม่ทา,TH/N_/51/อภ.แม่ทา,TH/N_/51,25067,12679,12388,10678
2375,อภ.แม่พริก,TH/N_/52/อภ.แม่พริก,TH/N_/52,9410,4792,4618,3189
2376,อภ.แม่ฟ้าหลวง,TH/N_/57/อภ.แม่ฟ้าหลวง,TH/N_/57,77355,38779,38576,24822
2377,อภ.แม่ระมาด,TH/W_/63/อภ.แม่ระมาด,TH/W_/63,49743,24213,25530,16697
2378,อภ.แม่ริม,TH/N_/เชียงใหม่/อภ.แม่ริม,TH/N_/เชียงใหม่,84810,43154,41656,37559
2379,อภ.แม่ลาน,TH/S_/94/อภ.แม่ลาน,TH/S_/94,17403,8861,8542,4473
2380,อภ.แม่ลาน้อย,TH/N_/58/อภ.แม่ลาน้อย,TH/N_/58,32334,16046,16288,10719
2381,อภ.แม่ลาว,TH/N_/57/อภ.แม่ลาว,TH/N_/57,24707,12663,12044,10856
2382,อภ.แม่วงก์,TH/CT/60/อภ.แม่วงก์,TH/CT/60,50204,25222,24982,18663
2383,อภ.แม่วาง,TH/N_/เชียงใหม่/อภ.แม่วาง,TH/N_/เชียงใหม่,27340,13738,13602,9783
2384,อภ.แม่สรวย,TH/N_/57/อภ.แม่สรวย,TH/N_/57,78107,38783,39324,29052
2385,อภ.แม่สอด,TH/W_/63/อภ.แม่สอด,TH/W_/63,96544,47783,48761,36020
2386,อภ.แม่สะเรียง,TH/N_/58/อภ.แม่สะเรียง,TH/N_/58,52381,25958,26423,21357
2387,อภ.แม่สาย,TH/N_/57/อภ.แม่สาย,TH/N_/57,69770,36839,32931,28865
2388,อภ.แม่ออน,TH/N_/เชียงใหม่/อภ.แม่ออน,TH/N_/เชียงใหม่,21090,10635,10455,9411
2389,อภ.แม่อาย,TH/N_/เชียงใหม่/อภ.แม่อาย,TH/N_/เชียงใหม่,67479,33732,33747,27851
2390,อภ.แม่เปิน,TH/CT/60/อภ.แม่เปิน,TH/CT/60,20907,10395,10512,6903
2391,อภ.แม่เมาะ,TH/N_/52/อภ.แม่เมาะ,TH/N_/52,24187,12016,12171,8965
2392,อภ.แม่แจ่ม,TH/N_/เชียงใหม่/อภ.แม่แจ่ม,TH/N_/เชียงใหม่,57291,28219,29072,17996
2393,อภ.แม่แตง,TH/N_/เชียงใหม่/อภ.แม่แตง,TH/N_/เชียงใหม่,60010,30135,29875,24369
2394,อภ.แม่ใจ,TH/N_/56/อภ.แม่ใจ,TH/N_/56,20327,10478,9849,9431
2395,อภ.แวงน้อย,TH/NE/ขอนแก่น/อภ.แวงน้อย,TH/NE/ขอนแก่น,38804,19463,19341,11268
2396,อภ.แวงใหญ่,TH/NE/ขอนแก่น/อภ.แวงใหญ่,TH/NE/ขอนแก่น,24214,12212,12002,6363
2397,อภ.แว้ง,TH/S_/96/อภ.แว้ง,TH/S_/96,43630,22116,21514,10323
2398,อภ.แสวงหา,TH/CT/15/อภ.แสวงหา,TH/CT/15,30916,15839,15077,9961
2399,อภ.แหลมงอบ,TH/E_/23/อภ.แหลมงอบ,TH/E_/23,13999,7081,6918,5784
2400,อภ.แหลมสิงห์,TH/E_/22/อภ.แหลมสิงห์,TH/E_/22,14233,7304,6929,5300
2401,อภ.โกรกพระ,TH/CT/60/อภ.โกรกพระ,TH/CT/60,26809,13739,13070,9614
2402,อภ.โกสัมพีนคร,TH/CT/62/อภ.โกสัมพีนคร,TH/CT/62,28227,14101,14126,10629
2403,อภ.โกสุมพิสัย,TH/NE/44/อภ.โกสุมพิสัย,TH/NE/44,109864,55642,54222,31504
2404,อภ.โขงเจียม,TH/NE/34/อภ.โขงเจียม,TH/NE/34,35508,17532,17976,10010
2405,อภ.โคกศรีสุพรรณ,TH/NE/47/อภ.โคกศรีสุพรรณ,TH/NE/47,21810,10964,10846,7534
2406,อภ.โคกสำโรง,TH/CT/16/อภ.โคกสำโรง,TH/CT/16,76432,38536,37896,28633
2407,อภ.โคกสูง,TH/E_/27/อภ.โคกสูง,TH/E_/27,27236,13727,13509,8277
2408,อภ.โคกเจริญ,TH/CT/16/อภ.โคกเจริญ,TH/CT/16,24384,12198,12186,8472
2409,อภ.โคกโพธิ์,TH/S_/94/อภ.โคกโพธิ์,TH/S_/94,62195,31812,30383,17737
2410,อภ.โคกโพธิ์ไชย,TH/NE/ขอนแก่น/อภ.โคกโพธิ์ไชย,TH/NE/ขอนแก่น,21142,10558,10584,6523
2411,อภ.โชคชัย,TH/NE/30/อภ.โชคชัย,TH/NE/30,49635,25552,24083,18937
2412,อภ.โซ่พิสัย,TH/NE/38/อภ.โซ่พิสัย,TH/NE/38,65011,32296,32715,19008
2413,อภ.โนนคูณ,TH/NE/33/อภ.โนนคูณ,TH/NE/33,39433,19595,19838,10878
2414,อภ.โนนดินแดง,TH/NE/31/อภ.โนนดินแดง,TH/NE/31,18717,9259,9458,5713
2415,อภ.โนนนารายณ์,TH/S_/32/อภ.โนนนารายณ์,TH/S_/32,34988,17580,17408,8548
2416,อภ.โนนศิลา,TH/NE/ขอนแก่น/อภ.โนนศิลา,TH/NE/ขอนแก่น,21020,10534,10486,6383
2417,อภ.โนนสะอาด,TH/NE/41/อภ.โนนสะอาด,TH/NE/41,45363,22715,22648,11984
2418,อภ.โนนสัง,TH/NE/39/อภ.โนนสัง,TH/NE/39,54073,27184,26889,13567
2419,อภ.โนนสุวรรณ,TH/NE/31/อภ.โนนสุวรรณ,TH/NE/31,21867,10936,10931,6329
2420,อภ.โนนสูง,TH/NE/30/อภ.โนนสูง,TH/NE/30,85180,43431,41749,24870
2421,อภ.โนนแดง,TH/NE/30/อภ.โนนแดง,TH/NE/30,20919,10676,10243,5555
2422,อภ.โนนไทย,TH/NE/30/อภ.โนนไทย,TH/NE/30,54797,27909,26888,16641
2423,อภ.โป่งน้ำร้อน,TH/E_/22/อภ.โป่งน้ำร้อน,TH/E_/22,21176,10296,10880,8487
2424,อภ.โพทะเล,TH/CT/66/อภ.โพทะเล,TH/CT/66,54660,27934,26726,18686
2425,อภ.โพธาราม,TH/W_/70/อภ.โพธาราม,TH/W_/70,71850,37001,34849,25130
2426,อภ.โพธิ์ชัย,TH/NE/45/อภ.โพธิ์ชัย,TH/NE/45,26995,13557,13438,7375
2427,อภ.โพธิ์ตาก,TH/NE/43/อภ.โพธิ์ตาก,TH/NE/43,15284,7625,7659,5136
2428,อภ.โพธิ์ทอง,TH/CT/15/อภ.โพธิ์ทอง,TH/CT/15,43800,22935,20865,15385
2429,อภ.โพธิ์ประทับช้าง,TH/CT/66/อภ.โพธิ์ประทับช้าง,TH/CT/66,33912,17188,16724,11452
2430,อภ.โพธิ์ศรีสุวรรณ,TH/NE/33/อภ.โพธิ์ศรีสุวรรณ,TH/NE/33,23726,11829,11897,5621
2431,อภ.โพธิ์ไทร,TH/NE/34/อภ.โพธิ์ไทร,TH/NE/34,44372,21820,22552,11799
2432,อภ.โพนทราย,TH/NE/45/อภ.โพนทราย,TH/NE/45,22410,11192,11218,5099
2433,อภ.โพนทอง,TH/NE/45/อภ.โพนทอง,TH/NE/45,96803,48707,48096,28159
2434,อภ.โพนนาแก้ว,TH/NE/47/อภ.โพนนาแก้ว,TH/NE/47,36855,18402,18453,13491
2435,อภ.โพนพิสัย,TH/NE/43/อภ.โพนพิสัย,TH/NE/43,95632,47992,47640,31376
2436,อภ.โพนสวรรค์,TH/NE/48/อภ.โพนสวรรค์,TH/NE/48,52550,26302,26248,16797
2437,อภ.ไชยปราการ,TH/N_/เชียงใหม่/อภ.ไชยปราการ,TH/N_/เชียงใหม่,34535,17280,17255,11531
2438,อภ.ไชยวาน,TH/NE/41/อภ.ไชยวาน,TH/NE/41,23765,11750,12015,5985
2439,อภ.ไชยา,TH/S_/84/อภ.ไชยา,TH/S_/84,38623,19718,18905,16594
2440,อภ.ไชโย,TH/CT/15/อภ.ไชโย,TH/CT/15,7121,3697,3424,2387
2441,อภ.ไทยเจริญ,TH/NE/35/อภ.ไทยเจริญ,TH/NE/35,30433,15252,15181,10206
2442,อภ.ไทรงาม,TH/CT/62/อภ.ไทรงาม,TH/CT/62,45391,22806,22585,14860
2443,อภ.ไทรน้อย,TH/CT/12/อภ.ไทรน้อย,TH/CT/12,68295,35734,32561,32063
2444,อภ.ไทรโยค,TH/W_/71/อภ.ไทรโยค,TH/W_/71,59096,28535,30561,20932
2445,อภ.ไพรบึง,TH/NE/33/อภ.ไพรบึง,TH/NE/33,36656,18477,18179,9050
2446,อภ.ไพศาลี,TH/CT/60/อภ.ไพศาลี,TH/CT/60,59944,30263,29681,20948
2447,อภ.ไม้แก่น,TH/S_/94/อภ.ไม้แก่น,TH/S_/94,12940,6552,6388,3381
2448,11,TH/CT/11,TH/CT,1351479,706963,644516,711804
2449,12,TH/CT/12,TH/CT,1276745,682437,594308,718799
2450,14,TH/CT/14,TH/CT,819088,425537,393551,336357
2451,15,TH/CT/15,TH/CT,276584,144191,132393,101291
2452,16,TH/CT/16,TH/CT,742928,371771,371157,299338
2453,17,TH/CT/17,TH/CT,205898,108001,97897,78410
2454,18,TH/CT/18,TH/CT,322477,167464,155013,126673
2455,19,TH/CT/19,TH/CT,643828,327323,316505,283069
2456,21,TH/E_/21,TH/E_,741524,377324,364200,506761
2457,22,TH/E_/22,TH/E_,535559,273532,262027,243727
2458,23,TH/E_/23,TH/E_,228536,115405,113131,108270
2459,24,TH/E_/24,TH/E_,720718,367276,353442,313586
2460,25,TH/E_/25,TH/E_,493670,249652,244018,220064
2461,26,TH/CT/26,TH/CT,260081,131454,128627,101547
2462,27,TH/E_/27,TH/E_,560925,280908,280017,217621
2463,30,TH/NE/30,TH/NE,2633207,1338585,1294622,1004213
2464,31,TH/NE/31,TH/NE,1581184,795962,785222,476118
2465,32,TH/S_/32,TH/S_,1378221,692421,685800,403890
2466,33,TH/NE/33,TH/NE,1458580,732274,726306,399090
2467,34,TH/NE/34,TH/NE,1866697,934297,932400,616810
2468,35,TH/NE/35,TH/NE,534500,267484,267016,175666
2469,36,TH/NE/36,TH/NE,1124924,568879,556045,400583
2470,37,TH/NE/37,TH/NE,376195,188886,187309,120188
2471,38,TH/NE/38,TH/NE,422042,210369,211673,137871
2472,39,TH/NE/39,TH/NE,509470,255239,254231,152361
2473,41,TH/NE/41,TH/NE,1567983,790876,777107,528347
2474,42,TH/NE/42,TH/NE,638736,318571,320165,226892
2475,43,TH/NE/43,TH/NE,517435,260612,256823,178748
2476,44,TH/NE/44,TH/NE,953660,486163,467497,304433
2477,45,TH/NE/45,TH/NE,1298640,654422,644218,394597
2478,46,TH/NE/46,TH/NE,977175,493728,483447,311145
2479,47,TH/NE/47,TH/NE,1146936,576651,570285,387699
2480,48,TH/NE/48,TH/NE,717201,359607,357594,231315
2481,49,TH/NE/49,TH/NE,350911,175544,175367,117741
2482,51,TH/N_/51,TH/N_,402011,208630,193381,182323
2483,52,TH/N_/52,TH/N_,728964,373706,355258,295396
2484,53,TH/N_/53,TH/N_,448745,229757,218988,172565
2485,54,TH/N_/54,TH/N_,437350,226377,210973,179040
2486,55,TH/N_/55,TH/N_,476727,237989,238738,170708
2487,56,TH/N_/56,TH/N_,467356,239670,227686,195004
2488,57,TH/N_/57,TH/N_,1295026,665066,629960,558825
2489,58,TH/N_/58,TH/N_,284549,140238,144311,115163
2490,60,TH/CT/60,TH/CT,1040308,532929,507379,420803
2491,61,TH/CT/61,TH/CT,325868,166546,159322,125666
2492,62,TH/CT/62,TH/CT,714118,361407,352711,278306
2493,63,TH/W_/63,TH/W_,670265,331314,338951,224890
2494,64,TH/CT/64,TH/CT,587883,302934,284949,220160
2495,65,TH/CT/65,TH/CT,849481,433247,416234,352300
2496,66,TH/CT/66,TH/CT,532310,272659,259651,198230
2497,67,TH/CT/67,TH/CT,981940,497054,484886,364119
2498,70,TH/W_/70,TH/W_,869313,446482,422831,325837
2499,71,TH/W_/71,TH/W_,891976,443993,447983,348371
2500,72,TH/CT/72,TH/CT,838628,433970,404658,306999
2501,73,TH/CT/73,TH/CT,920729,478845,441884,411586
2502,74,TH/CT/74,TH/CT,586199,303476,282723,296825
2503,75,TH/CT/75,TH/CT,192052,100227,91825,72732
2504,76,TH/W_/76,TH/W_,482193,249278,232915,220362
2505,81,TH/S_/81,TH/S_,477770,240528,237242,193701
2506,82,TH/S_/82,TH/S_,268229,134486,133743,118609
2507,83,TH/S_/83,TH/S_,414471,218676,195795,272917
2508,84,TH/S_/84,TH/S_,1067726,542010,525716,512366
2509,85,TH/S_/85,TH/S_,194372,96218,98154,92739
2510,86,TH/S_/86,TH/S_,509208,257838,251370,240248
2511,90,TH/S_/90,TH/S_,1428609,732260,696349,553597
2512,91,TH/S_/91,TH/S_,324098,162795,161303,105903
2513,92,TH/S_/92,TH/S_,640574,327206,313368,234863
2514,93,TH/S_/93,TH/S_,523077,268169,254908,197086
2515,94,TH/S_/94,TH/S_,726015,367404,358611,195224
2516,95,TH/S_/95,TH/S_,538602,270683,267919,170091
2517,96,TH/S_/96,TH/S_,804429,406729,397700,219403
2518,กรุงเทพมหานคร,TH/CT/กรุงเทพมหานคร,TH/CT,5588222,2962284,2625938,3103483
2519,ขอนแก่น,TH/NE/ขอนแก่น,TH/NE,1794531,912069,882462,640781
2520,ชลบุรี,TH/E_/ชลบุรี,TH/E_,1566885,802902,763983,1070209
2521,นครศรีธรรมราช,TH/S_/นครศรีธรรมราช,TH/S_,1550721,785351,765370,581948
2522,ปทุมธานี,TH/CT/ปทุมธานี,TH/CT,1176412,618660,557752,642474
2523,ประจวบคีรีขันธ์,TH/W_/ประจวบคีรีขันธ์,TH/W_,550678,277829,272849,271890
2524,เชียงใหม่,TH/N_/เชียงใหม่,TH/N_,1784370,921496,862874,835977
2525,CT,TH/CT,TH,20233258,10529379,9703879,9550971
2526,E_,TH/E_,TH,4847817,2466999,2380818,2680238
2527,NE,TH/NE,TH,20470007,10320218,10149789,6804598
2528,N_,TH/N_,TH,6325098,3242929,3082169,2705001
2529,S_,TH/S_,TH,10846122,5502774,5343348,4092585
2530,W_,TH/W_,TH,3464425,1748896,1715529,1391350
2531,TH,TH,,66186727,33811195,32375532,27224743
